212121212121212121133131313131313131313131313114
211331313131313131320000000000000000000000000020
212200000000000000000000000000000000000000000020
212200101111120000000000000000001012000000000020
212200202121231200000000000010112423111200000020
212200303131313200000000001024212121212200000020
212200000000000000000000002021212121212200000020
212200000000000000000000002021212121212200000020
212312000010120000000000003014212121212200000020
133132000030331200000000000030311413313200000020
220000000000303312000000000000002022000000000020
220000000000003033120000000000002022000000000020
220000000000000030320000000000002023111111111124
220000000000000000000000000000003031313131313114
220000000000000000000000000000000000000000000020
231111111111111111120000000000000000000000000020
212121212121212121220000000000000000000000000020
212121212121212121231111111111111111111111111124

sprite sprite:donkey @1,2 0x01020304
image image:library
