21212121212121212121212121212121212121212121212121212121212121212121212121212121
21212121212121212121212121212121212121212121212121212121212121212121212121212121
21212121212121212121212121212121212121212121212121212121212121212121212121212121
21212113313131313131313131313131313131313131313131313131313131313131313114212121
21212122000000000000000000000000000000000000000000000000000000000000000020212121
21212122000000000000000000000000000000000000000000001011111111111111120020212121
21212122001011111111111111111111111111111200000000002013313131313131320020212121
21212122003031313131313131313131313131142200000000002022000000000000000020212121
21212122000000000000000000000000000000202200000000002023111111111111111124212121
21212122000000000000000000000000000000202200000000003031142113313131313114212121
21212123111111111111111111111111111200202200000000000000202122000000000020212121
21212113313131313131311413313131142200202311111111111200202122001012000020212121
21212122000000000000002022000000202200201331313131142200202122002022000020212121
21212122000000000000002022000000202200202200000000202200202122002022000020212121
21212122000000000000002022000000303200202200000400202200303132002022000020212121
21212122000000101200002022000000000000202200000000202200000000002022000020212121
21212122000000202200002022000000101200202200000000202311111111112422000020212121
21212122000000202200002022000000202200202311111200303131313131311422000020212121
21212122000000202200002022000000202200202121212200000000000000002022000020212121
21212122000000202200002022000000202200303114212311111111111112002022000020212121
21212122000000202200002022000000202200000020211331313131313132002022000020212121
21212122000000202200002023120010242311120020212200000000000000002022000020212121
21212122000000202200002013320030313114220020212200101111111111112422000020212121
21212122000000202200002022000000000020220030313200201331313131313132000020212121
21212122000000202200003032000000000020220000000000202202020202020202020220212121
21212122000000202200000000000000000020220000000000202202024041414142020220212121
21212122000000202311111112000000000020220000000000202202025051515152020220212121
21212122000000303131311422000000000020220000000000202202025051515152020220212121
21212122000000000000002022000000000020220000000000202202025051515152020220212121
21212122000000000000002022000000000020220000000000202202026061616162020220212121
21212122000000000000002022000000000020220000000000202202020202020202020220212121
21212123111111120010112423111200101124231112001011242311111111111111111124212121
21212113313131320030313131313200303131313132003031313131311413313131313114212121
21212122000000000000000000000000000000000000000000000000003032020202020220212121
21212122000000000000000000000000000000000000000000000000000000020203020220212121
21212122000000000000000000000000000000000000000000000000001012020202020220212121
21212123111111111111111111111111111111111111111111111111112423111111111124212121
21212121212121212121212121212121212121212121212121212121212121212121212121212121
21212121212121212121212121212121212121212121212121212121212121212121212121212121
21212121212121212121212121212121212121212121212121212121212121212121212121212121

image image:queen
song song:light_chambers
battlebg (u16)5
door @33,34 map:library @23,5 0x0000
sprite sprite:queen @31,27 flag:book6 0x000000
battle battle:skeleton 0x0008
sprite sprite:kitchen @23,7 0x00802101
sprite sprite:bodyguard @8,32 flag:bodyguard1 0x000000
sprite sprite:bodyguard @15,32 flag:bodyguard2 0x000000
sprite sprite:bodyguard @22,32 flag:bodyguard3 0x000000
sprite sprite:bodyguard @12,25 flag:bodyguard4 0x000000
sprite sprite:bodyguard @14,22 flag:bodyguard5 0x000000
sprite sprite:bodyguard @20,23 flag:bodyguard6 0x000000
sprite sprite:bodyguard @24,23 flag:bodyguard7 0x000000
sprite sprite:bodyguard @17,15 flag:bodyguard8 0x000000
sprite sprite:bodyguard @26,4 flag:bodyguard9 0x000000
sprite sprite:bodyguard @4,7 flag:bodyguard10 0x000000
sprite sprite:juliet @22,15 0x00000000
flagtile @23,14 flag:flower_done 0
