21212121212121212121212121212121212121212121212121212121212121212121212121212121
21212121212121212121212121212121212121212121212121212121212121212121212121212121
21212121212121212121212121212121212121212121212121212121212121212121212121212121
21212113313131313131313131313131313131313131313131313131313131313131313114212121
21212122000000000000000000000000000000000000000000000000000000000000000020212121
21212122000000000000000000000000000000000000000000001011111111111111120020212121
21212122001011111111111111111111111111111200000000002013313131313131320020212121
21212122003031313131313131313131313131142200000000002022000000000000000020212121
21212122000000000000000000000000000000202200000000002023111111111111111124212121
21212122000000000000000000000000000000202200000000003031142113313131313114212121
21212123111111111111111111111111111200202200000000000000202122000000000020212121
21212113313131313131311413313131142200202311111111111200202122001012000020212121
21212122000000000000002022000000202200201331313131142200202122002022000020212121
21212122000000000000002022000000202200202200000000202200202122002022000020212121
21212122000000000000002022000000303200202200000000202200303132002022000020212121
21212122000000101200002022000000000000202200000000202200000000002022000020212121
21212122000000202200002022000000101200202200000000202311111111112422000020212121
21212122000000202200002022000000202200202311111200303131313131311422000020212121
21212122000000202200002022000000202200202121212200000000000000002022000020212121
21212122000000202200002022000000202200303114212311111111111112002022000020212121
21212122000000202200002022000000202200000020211331313131313132002022000020212121
21212122000000202200002023120010242311120020212200000000000000002022000020212121
21212122000000202200002013320030313114220020212200101111111111112422000020212121
21212122000000202200002022000000000020220030313200201331313131313132000020212121
21212122000000202200003032000000000020220000000000202200000000000000000020212121
21212122000000202200000000000000000020220000000000202200000000000000000020212121
21212122000000202311111112000000000020220000000000202200000000000000000020212121
21212122000000303131311422000000000020220000000000202200000000000000000020212121
21212122000000000000002022000000000020220000000000202200000000000000000020212121
21212122000000000000002022000000000020220000000000202200000000000000000020212121
21212122000000000000002022000000000020220000000000202200000000000000000020212121
2121212311111112001011242311120010112423111200101124231111111111120e101124212121
21212113313131320030313131313200303131313132003031313131311413313200303114212121
21212122000000000000000000000000000000000000000000000000003032000000000020212121
21212122000000001500000000000025000000000000250000000000000000000003000020212121
21212122000000000000000000000000000000000000000000000000001012000000000020212121
21212123111111111111111111111111111111111111111111111111112423111111111124212121
21212121212121212121212121212121212121212121212121212121212121212121212121212121
21212121212121212121212121212121212121212121212121212121212121212121212121212121
21212121212121212121212121212121212121212121212121212121212121212121212121212121

image image:library
song song:open_arms
door @33,34 map:library @23,5 0x0000
sprite sprite:queen @31,27 flag:book6 0x000000
battle battle:skeleton 0x1000
sprite sprite:kitchen @23,7 0x00802101
flagtile @33,31 flag:book6 0
