212121212121212121212121212121212121212121212121212121212121212121212121
212121212121212121212121212121212121212121212121212121212121212121212121
212113313131313114212121212113313131313131313131313131313131313131142121
212122020202020220133131311422000000000000000000000000000000000000202121
212122020202020220220202022022000000101111111111111111111111111200202121
212122020203020220220202022022000000201331313131313131313114212200202121
212122020202020220220202022022001011242200000000000000000030313200202121
212122020202020220231202102422002013313200000000000000000000000000202121
212123111112020230313202303132002022000000000000000000000010111200202121
212121212122020201020202000000002022000000000000000000000020212200202121
212121212122001011111111111111112423111111111112000000000020212200202121
212113313132003031313131041413313104313114212122000000000020212200202121
212122000000000000000000002022000000000030142123120010111124212311242121
212122001011111111111111112422000000000000301413320030313114212121212121
212122002013313131310431311422000000000000002022000000000020212121212121
212122002022000000000000003032000000000000002022000000000020212121212121
212122002022000000000000000000000000000000002022000000000020212121212121
212122003032000000000000001012000000000000002022000000000020212121212121
212122000000000000000000002022000000000000102423111200101124212121212121
212122001012000000000000002023111200000000201331313200303131313131142121
212122002022000000000000002021212200000000202200000000000000000000202121
212122002022000000000000002021212311111111242200000000000000000000202121
212123112423111112001011112413310431311421212200000000000000000000202121
212121133131313132003014133132000000002021212200000000000000000000202121
212121220000000000000030320000000000002021212311111111111200101111242121
212121220000000000000000000000000000102413313131311413313200303131142121
212121220000000000000010120000000010241332000000002022000000000000202121
212121231112001011111124231111111124133200000000003032000000000000202121
212113313132003031313131313131311413320000000000000000000000000000202121
212122000000000000000000000000003032000000000000001012000000000000202121
212122000000000000000000000000000000000000000000002022000000000000202121
212122000000000000000000000000001012000000000000002023111111111111242121
212122000000000000000000000000002022000000000000002021212121212121212121
212123111111111111111111111111112423111111111111112421212121212121212121
212121212121212121212121212121212121212121212121212121212121212121212121
212121212121212121212121212121212121212121212121212121212121212121212121

image image:cellar
song song:prettier_with_lights_out
battlebg (u16)4
battle battle:skeleton 0x0003
battle battle:eyeball 0x0002
battle battle:rabbit 0x0001
door @5,5 map:1 @25,5 0 0
sprite sprite:sixclops @11,5 flag:book5 0x000000
sprite sprite:kitchen @16,4 0x40400810
flagtile @8,9 flag:book5 0
lights @12,11 @5,14,9,9 flag:lights1 0
lights @10,14 @14,11,9,11 flag:lights2 0
lights @16,22 @2,28,15,6 flag:lights3 0
lights @17,11 @19,2,19,10 flag:lights4 0
sprite sprite:terror @6,15 0x00000000
sprite sprite:terror @12,15 0x00000000
sprite sprite:terror @12,18 0x00000000
sprite sprite:terror @8,21 0x00000000
sprite sprite:terror @10,21 0x00000000
sprite sprite:terror @17,16 0x00000000
sprite sprite:terror @6,30 0x00000000
sprite sprite:terror @23,30 0x00000000
sprite sprite:terror @25,10 0x00000000
sprite sprite:terror @27,7 0x00000000
