133131313131313131313131313131313131311413313131313131313131313131313131313131313131313131313131313131313131313132000000000000000000000000000000303131313200303200000035000035003031313200303200000035000030313132002500000000000000000000000000
220000000000000000000000000000000000002022002500000000000000000000000000000000000000000000000000000000000000000000000000000000002500251500251525000000000000000000000000000000000000000000000000000000000000000000000000253535251535350000000000
220010111111120000000000000000001012002022000025350025000025003535250035350015152525151500250000350000352515252525001500352535150000000000000000000000000000000000000000000000000000000000000000000000000000000000000000000000000000253500000000
220030313131320000000000000000002022002022000000000000000000000000000000000000000000000000000000000000000000000000000000000000000000000000000000000000000000000000000000000000000000000000000000000000000000000000000000000000000000001535000000
220000000000000010111112001011112422003032000000000000000000000000000000000000000000000000000000000000000000000000000000000000000000000000000000000000000000000000000000000000000000000000000000000000000000000000000000000000000000000035000000
220010111111120020212122003031313132000000000000000000000000000000000000000000000000000000000000000000000000000000000000000000000000000000000000000000000000000000000000000000000000000000000000000000000000000000000000000000000000000035000000
220020133131320030313132000000000000000000000000000000000000000000000000000000000000000000000000000000002535150000000000000000000000000000000000000000000000000000000000000000000000000000000000000000000000000000000000000000000000000000250000
220020220000000000000000001011111112001012000000000000000000000000000000000000000000000000000000000000002500001500000000001500000000000000000000000000000000000000000000000000000000000000000000000000000000000000000000000000000000000000150000
220030320000000000000000003031313132002023120025000000000000000000000000000000000000000000000000000000001012352500000000000000000000000000000000000000000000000000000000000000000000001011120000000000000000000000000000000000000000000000350000
220000000000000000000000000000000000002021231200101200000000000000000000000000000000000000000000000000003032002500252500003500000015353500000000000000000000000000001525000015101112353031320000000000000000000000000000000000000000000000150000
231111111111111112000010111111111111112421212200303200000000000000000000000000000000000000000000000000002500000000002500003500001012001500000000000000000000000000250000150000301422000000152525000000000000000000000000000000000000000000003500
133131313131313132000020212121212121212121212311120000000000000000000000000000000000000000000000000000003515153525150000002500003032002500000000000000000000002500003500150015003033111112002500150000000000000000000000000000000000000000001500
220035000000000000000030142121211331142121212121231200000000000000000000000000000000150035000000000000000000000000000000003500000035151535000000000000000000000025001011120000350030311423120000150000000000000000000000000000000000000000002500
220025000000000000000000202113313200202121212121212200000000000000000000252515350025000000000000000000000000000000000000000000000000000025000000000000000000150015352013323510120000003031321525250000000000000000000000000000000000000000002500
220035000000000000000000301422003525301421212113313200000000000000000025000000250000000000000000000000000000000000000000000000000000003515000000000000000000253515003032000030321012150035000000250000000000000000000000000000000000000000001500
220015350000000000000000003032000025003031313132000000000000000000000000252510111111120000000000000000000000000000000015000000000015150000000000000000000000350035003500001500002022002515000010120000000000000000000000000000000000000000002500
220000250000000000000000000015101225353500000000000000000000000000000000250030311421220000000000000000000000000000000035352535002515000000000000000000000000101112003500101200002022001500150020220000000000000000000000000000000000000000250000
220000250000000000000000000000303200000000000000000000000000000000000000351012002013320000000000000000000000000000000000000000000000000000000000000000000000202122001012303200002022351500001024220000000000000000000000000000000000000000150000
220000350000000000000000000000000000000000000000000000000000000000000000003032152022000000000000000000000000000000000000000000000000000000000000000000000000301422353032001012353032000000002021220000000000000000000000000000000000000000250000
220000350000000000000000000000000000000000000000000000000000000000000000000035003032000000000000000000000000000000000000000000000000000000000000000000000000003032000025353032003500003515153014220000000000000000000000000000000000000000250000
220000150000000000000000000000000000000000000000000000000000000000000000000000000000000000000000000000000000000000000000000000000000000000000000000000000000000025253500250000101235351500150030320000000000000000000000000000000000000000150000
220000150000000000000000000000000000000000000000000000000000000000000000000000000000000000000000000000000000000000000000000000000000000000000000000000000000000000003525250015303200003535001500000000000000000000000000000000000000000000150000
220000000000000000000000000000000000000000000000000000000000000000000000000000000000000000000000000000000000000000000000000000000000000000000000000000000000000000000000002500250035000000000000000000000000000000000000000000000000000000350000
220000350000000000000000000000000000000000000000000000000000000000000000000000000000000000000000000000000000000000000000000000000000000000000000000000000000000000000000000000000000000000000000000000000000000000000000000000000000000000002500
220000250000000000000000000000000000000000000000000000000000000000000000000000000000000000000000000000000000000000000000000000000000000000000000000000000000000000000000000000000000000000000000000000000000000000000000000000000000000000003500
220000000000000000000000000000000000000000000000000000000000000000000000000000000000000000000000000000000000000000000000000000000000000000000000000000000000000000000000000000000000000000000000000000000000000000000000000000000000000000000000
220000350000000000000000000000000000000000000000000000000000000000000000000000000000000000000000000000000000000000000000000000000000000000000000000000000000000000000000000000000000000000000000000000000000000000000000000000000000000000001500
220000000000000000000000000000000000000000000000000000000000000000000000000000000000000000000000000000000000003535000000000000000000000000000000000000000000000000000000000000000000000000000000000000000000000000000000000000000000000000000000
220000350000000000000000000000000000000000000000000000000000000000000000000000000000000000000000000035000010123500000000000000000000000000000000000000000000000000000000000000000000000000000000000000000000000000000000000000000000000000000000
220000250000000000000000000000000000000000000000000000000000000000000000000000000000000000000000150000000030320000000000000000000000000000000000001500000000000000000000000000000000000000000000000000000000000000000000000000000000000000003500
320000250000000000000000000000000000000000000000000000000000000000000000000000000000000000003535000000003500000000000000000000000000000000000000250000000000000000000000000000000000000000000000000000000000000000000000000000000000000000001500
000000350000000000000000000000000025250000000000000000000000000000000000000000000000000035150000000000150000000000000000000000000000000000002525000000000000000000000000000000000000000000000000000000000000000000000000000000000000000000000000
000015000000000000000000000000003500002500000000000000000000000000000000000000000000251500000000000015000000000000000000000000000000000035000000000000000000000000000000000000000000000000000000000000000000000000000000000000000000000000003500
000000000000000000000000000015250000153500000000000000000000000000000000000000150015000000000000002500000000000000000000000000000000000000000000000000000000000000000000000000000000000000000000000000000000000000000000000000000000000000002500
000015000000000000000000003515000000350000000000000000000000000000000000000015000000000000000000003500000000000000000000000000000000350000000000000000000000000000000000000000000025150035000000000000000000000000001500000000000000000000002500
000035000000000000000000002500000000250000000000000000002500000000000000001500000000000000000000350000000000000000000000003500150000000000000000000000000000000000000000000025000000000000253500000000000000000000000015000000000000000000001500
000015000000000000000000000000000000250000000000000000250000000000000000000000000000000000002500000000000000000000001500250000000000000000000000000000000000000000000000250000000000000000000000000000000000000000000000000000000000000000000035
000015000000000000000000000000000035000000000000000000350000000000000000000000000000000000000000000000000000002500150000000000000000000000000000000000000000000000000000000000000000000000000015000000000000000000000000350000000000000000000000
000015000000000000000000000000000000000000000000000035000000000000000000000000000000000000000000000000000000250000000000000000000000000000000000000000000000000000002500000000000000000000000000000000000000000000000000150000000000000000000010
000035000000000000000000000000000000000000000000003500000000000000000000000000000000000015000000000000001500000000000000000000000000000000000000000000000000000000000000000000000000000000000035000000000000000000000000000000000000000000000020
000035000000000000000000000000001500000000000000001500000000000000000000000000000000000000000000000035000000000000000000000000000000000000000000000000000000000000250000000000000000000000000000001500000000000000000025000000000000000000000020
000000000000000000000000000000000000000000000000000000000000000000000000000000000000000000000000250000000000000000000000000000000000000000000000000000000000000000000000000000000000000000000000000000000000000000000025000000000000000000000030
000035000000000000000000000000002500000000000000350000000000000000000000000000000000250000003535000000000000000000000000000000000000000000000000000000000000003500000000000000000000000000000000000025000000000000001500000000000000000000000000
000035000000000000000000000000002500000000000015000000000000000000000000000000000025000015351500000000000000000000000000000000000000000000000000000000000000150000000000000000000000000000000000000000350035003500250000000000000000000000000010
000000000000000000000000000000000000000000001500000000000000000000000000000000003500001525000000000000000000000000000000000000000000000000000000000000000000350000000000000000000000000000000000000000000000000000000000000000000000000000000020
000035000000000000000000000000001500000000150000000000000000000000000000000000001012353500000000000000000000000000000000000000000000000000000000000000000000000000000000000000000000000000000000000000000000002500000000000000000000000000000020
000035000000000000000000000000003500002535000000000000000000000000000000000000103432000000000000000000000000000000000000000000000000000000000000000000000025000000000000000000000000000000000000000000000000351500000000000000000000000000000030
000025000000000000000000000000000025251500000000000000000000000000000000000000303200000000000000000000000000000000000000000000000000000000000000000000002525000000000000000000000000000000000000000000000035000000000000000000000000000000000000
000025000000000000000000000000000000000000000000000000000000000000000000000000000000000000000000000000000000000000000000000000000000000000000000000000000000000000000000000000000000000000000000000000000000003500000000000000000000000000000010
000035000000000000000000000000000000000000000000000000000000000000000000000000000000000000000000000000000000000000000000000000000000000000000000000000000000000000000000000000000000000000000000000000001500150000000000000000000000000000000020
000025000000000000000000000000000000000000000000000000000000000000002500000000000000000000000000000000000000000000000000000000000000000000000000000000000000000000000000000000000000000000000000000000000000350000000000000000000000000000000020
000000000000000000000000000000000000000000000000000000000000000000150015000000000000000000000000000000000000000000000000000000000000000000000000000000000000000000000000000000000000000000000000000000150000350000000000000000000000000000000030
002500000000001500000000000000000000000000000000000000000000000015000000000000000000000000000000000000000000150025000000000000000000000000000000000000000000000000000000000000000000000000000000000015000000250000000000000000000000000000000000
002500000000000000000000000000000000000000000000000000000000001500000000350000000000000000000000000000002500000025000000000000000000000000000000000000000000000000000000000000000000000000000000002500000000002500000000000000000000000000000035
001500000000003500000000000000000000000000000000000000000000150000000000000000000000000000000000000025000000000000000000000000000000000000000000000000000000000000000000000000000000000000000000002500000000000000000000000000003500000000000000
000000000000000000000000000000000000000000000000000000000035000000000000350000000000000000000000350000000000000000150000000000000000000000000000000000000000000000000000000000000000000000000000001500000000003500000000000000003500000000000010
002500000000000000000000000000000000000000000000000000000025000000000000000000000000000000002500000000000000000000000000000000000000000000000000000000000000000000000000000000000000000000000000001500000000000000000000000000000000000000000020
002500000000001500000000000000000000000000000000000000003500000000000000250000000000000000250000000000000000000000350000000000000000000000000000000000000000000000000000000000000000000000000000250000000000000025000000000000002500000000000020
003500000000000000000000000000000000000000000000000000150000000000000000003500000000000025000000000000000000000025000000000000000000000000000000000000000000000000000000000000000000000000000000350000000000000000000000000000003500000000000030
001500000000000025000000000000000000000000000000000000000000000000000000000000000000003500000000000000000000000000000000000000000000000000000000000000000000000000000000000000000000000000000000000000000000000000000000000000000000000000000000
001500000000000000000000000000000000000000000000000000150000000000000000002500000035350000000000000000000000003500000000000000000000000000000000000000000000000000000000000000000000000000000000000000000000000035000000000000350000000000002500
000000000000000035000000000000000000000000000000000000350000000000000000003500000025000000000000000000000000000000000000000000000000000000000000000000002535350000000000000000000000000000000000000000000000000000000000000000000000000000000000
000000000000000015000000000000000000000000000000000000000000000000000000000025000000000000000000000000000000002500000000000000000000000000000000002525000000001535000000000000000000000000000000000000000000000000000000000000000000000000000000
000000000000000000000000000000000000000000000000000035000000000000000000000000000000000000000000000000000000000000000000000000000000000000250035000000000000000000350000000035000000000000000000150000000000000035000000000035000000000000003500
000000000000000000350000000000000000000000000000000000000000000000000000000035000000000000000000000000000000150000000000000000000000251500000000000000000000000000003500000025000000000000000000000000000000000000000000000000000000000000000000
003500000000000000000000000000000000000000000000000035000000000000000000000000000000000000000000000000000000000000000000000000000025350000000000000000000000000000000035000035000000000000000000000000000000000025000000003500000000000000150000
000000000000000000003500000000000000000000000000000000000000000000000000000000150000000000000000000000000000350000000000000000000000000000000000000000000000000000000025353500000000000000000000150000000000000000000000000000000000000000350000
000000000000000000003500000000000000000000000000000000000000000000000000000000350000000000000000000000000000350000000000000000000000000000000000000000000000000000000000000000000000000000000000000000000000000000350000000000000000000000350000
000000000000000000000000350000000000000000000000000035000000000000000000000000000000000000000000000000000000252515000000000000000000000000000000000000000000000000000000000000000000000000000025000000000000000000350000003500000000000000250000
002500000000000000000000001500000000000000000000000000000000000000000000000000003500000000000000000000000000000000252535250000000000000000000000000000000000000000000000000000000000000000000000000000000000000000250000000000000000000000350000
002500000000000000000000000025000000000000000000002500000000000000000000000000000025000000000000000000000000000000000000003500000000000000000000000000000000000000000000000000000000000000000035000000000000000000001500000000000000000000350000
003500000000000000000000000000150000000000000000002500000000000000000000000000000035000000000000000000000000000000000000000000000000000000000000000000000000000000000000000000000000000000000025000000000000000000002500003500000000000000350000
000000000000000000000000000000000035003515002535000000000000000000000000000000000000350000000000000000000000000000000000000000000000000000000000000000000000000000000000000000000000000000000025000000000000000000000015000000000000000000150000
002500000000000000000000000000000000000000000000000000000000000000000000000000000000350000000000000000000000000000000000000000000000000000000000000000000000000000000000000000000000000000000000000000000000000000000035000000000000000000350000
003500000000000000000000000000000000000000000000000000000000000000000000000000000000001535000000000000000000000000000000000000000000000000000000000000000000000000000000000000000000000000000000000000000000000000000010120000000000000000150000
001500000000000000000000000000000000000000000000000000000000000000000000000000000000000000000000000000000000000000000000000000000000000000000000000000000000000000000000000000000000000000000000000000000000000000000030320000000000000000000000
001500000000000000000000000000000000000000000000000000000000000000000000000000000000000000000000000000000000000000000000000000000000000000000000000000000000000000000000000000000000000000000000000000000000000000000000000000000000000000250000
003500000000000000000000000000000000000000000000000000000000000000000000000000000000000000000000000000000000000000000000000000000000000000000000000000000000000000000000000000000000000000000000000000000000000000000000000000000000000000150000
001500000000000000000000000000000000000000000000000000000000000000000000000000000000000000000000000000000000000000000000000000000000000000000000000000000000000000000000000000000000000000000000000000000000000000000000000000000000000000001500
002500000000000000000000000000000000000000000000000000000000000000000000000000000000000000000000000000000000000000000000000000000000000000000000000000000000000000000000000000000000000000000000000000000000000000000000000000000000000000003500
002500000000000000000000000000000000000000000000000000000000000000000000000000000000000000000000000000000000000000000000000000000000000000000000000000000000000000000000000000000000000000000000000000000000000000000000000000000000000000001500
000000000000000000000000000000000000000000000000000000000000000000000000000000000000000000000000000000000000000000000000000000000000000000000000000000000000000000000000000000000000000000000000000000000000000000000000000000000000000000002500
000000000000000000000000000000000000000000000000000000000000000000000000000000000000000000000000000000000000000000000000000000000000000000000000000000000000000000000000000000000000000000000000000000000000000000000000000000000000000000003500
002500000000000000000000000000000000000000000000000000000000000000000000000000000000000000000000000000000000000000000000000000000000000000000000000000000000000000000000000000000000000000000000000000000000000000000000000000000000000000002500
003500000000000000000000000000000000000000000000000000000000000000000000000000000000000000000000000000000000000000000000000000000000000000000000000000000000000000000000000000000000000000000000000000000000000000000000000000000000000000003500
003500000000000000000000000000000000000000000000000000000000000000000000000000000000000000000000000000000000000000000000000000000000000000000000000000000000000000000000000000000000000000000000000000000000000000000000000000000000000000002500
001500000000000000000000000000000000000000000000000000000000000000000000000000000000000000000000000000000000000000000000000000000000000000000000000000000000000000000000000000000000000000000000000000000000000000000000000000000000000000003500
000000000000000000000000000000000000000000000000000000000000000000000000000000000000000000000000000000000000000000000000000000000000000000000000000000000000000000000000000000000000000000000000000000000000000000000000000000000000000000003500
001500000000000000000000000000000000000000000000000000000000000000000000000000000000000000000000000000000000000000000000000000000000000000000000000000000000000000000000000000000000000000000000000000000000000000000000000000000000000000003500
000000000000000000000000000000000000000000000000000000000000000000000000000000000000000000000000000000000000000000000000000000000000000000000000152500000000000000000000000000000000000000000000000000000000000000000000000000000000000000003500
000025000000000000000000000000000000000000000000000000000000000000000000000000000000000000000000000000000000000000000000000000000000000000000000350000000000000000000000000000000000000000000000000025000000000000000000000000000000000000003500
000035000000000000000000000000000000000000000000000000000000002515002515000025000000000000000000000000000000000000000000000000000000000000000000150000000000000000000000000000000000000000000000150015350000000000000000000000000000000000002500
000025000000000000000000000035252535153535150000000000000025000000000000000035250000000000000000000000000000150000000000000000000000000000000000350000000000000000000000000000000000000000001500000000000000000000000000001500000000000000003500
000015000000000000000000002500000000000000003525001500150000000000000000000000253500000000000000000000000000150000000000000000000000000000000025000000000000000000000000000000000000000000000000000000000035000000000000000025000000000000000000
000025000000000000000035250000000000000000000025003525000000000000000000000000002500000000000000000000000000250000000000000000000000000000000025000000000000000000000000000000000000001535000000000000000025000000000000000000000000000000003500
000025000000000000001500000000000000000000003500000000250000000000000000000000000015000000000000000000000025000000000000000000000000000000000015000000000000000000000000000000000000250000000000000000000000000000000000000000150000000000000000
000035000000000025250000000000000000000000250000000000003500000000000000000000000035000000000000000000000035153500000000000000000000000000001500000000000000000000000000000000000035000000000000000000000025000000000000000000000000000000001500
000000000000000015000000000000000000003500000000000000002515000000000000000000000035000000000000000000001500150025350000000000000000000000000000000000000000000000000000000000000000000000000000000000000000000000000000000000250000000000001500
000025000000000015000000000000000000250000000000000000000035000000000000000000000000250000000000000000002500000000000000250035000000000000001500000000000000000000000000000000000000000000000000000000000035000000000000000000000000000000001500
000025000000001500000000000000002500000000000000000000000035000000000000000000000000350000000000000000150000350000000000000000000000000000000000000000000000000000000000000000000015000000000000000000000000000000000000000000150000000000001500
000035000000000000000000000000000000000000000000000000000000000000000000000000000000350000000000001515000000000000000000000000000000000000002500000000000000000000000000000000000015000000000000000000002500000000000000000000000000000000001500
000015000000000000000000000000003500000000000000000000000015000000000000000000000000350000000000252500000000001500000000000000000000000000001500000000000000000000000000000000000000000000000000000000002500000000000000000000000000000000003500
000025000000000000000000000000350000000000000000000000000000350000000000000000000025000000000000002500000000003500000000000000000000000000000000000000000000000000000000000000000035000000000000000000250000000000000000000000150000000000001500
000035000000000000000000000000150000000000000000000000000000000000000000000000000015000000000000000000000000000035000000000000000000000000001500000000000000000000000000000000000035000000000000000000350000000000000000000000350000000000003500
000015000000000000000000000000350000000000000000000000000000250000000000000000001500000000000000000000000000000000000000000000000000000000000000000000000000000000000000000000000025000000000000000025000000000000000000000000000000000000003500
000015000000000000000000000000001500000000000000000000000000000000000000000000000000000000000000000000000000000015000000000000000000000000002500000000000000000000000000000000000035000000000000001500000000000000000000000000350000000000250000
001500000000000000000000000000001500000000000000000000000000350000000000000000003500000000000000000000000000000015000000000000000000000000000000000000000000000000000000000000000000250000000000000000000000000000000000000000350000000000150000
001500000000000000000000000000000035000000000000000000000025000000000000000000350000000000000000000000000000000000000000000000000000000000000015000000000000000000000000000000000000250000000000350000000000000000000000000025000000000000150000
002500000000000000000000000000000025250000000000000000002500000000000000000000000000000000000000000000000000000035000000000000000000000000000000350000000000000000000000000000000000000000000000000000000000000000000000000000000000000000150000
003500000000000000000000000000000000150000000000000035000000000000000000000035000000000000000000000000000000000035000000000000000000000000000000003500000000000000000000000000000000001500001500000000000000000000000000000035000000000000150000
001500000000000000000000000000000000000035003515000000000000000000000000002500000000000000000000000000000000000010120000000000000000000000000000000000250000000000000000000000000000000000150000000000000000000000000000002500000000000000150000
001500000000000000000000000000000000000000000000000000000000000000000000150000000000000000000000000000000035000030320000000000000000000000000000000000002515001500000000000000000000000015000025000000000000000000000000250000000000000000001500
350000000000000000000000000000000000000000000000000000000000000000000035000000000000000000000000000000000000002525000000000000000000000000000000000000000000000035152500350000000000002500000000003500000000000000000035000000000000000000001500
000000000000000000000000000000000000000000000000000000000000000000000000000000000000000000000000000000000000352500000000000000000000000000000000000000000000000000000000000015003515150000000000000000000015001500350000000000000000000000001500
120000000000000000000000000000000000000000000000000000000000000000000000000000000000000000000000000000000000250000000000000000000000000000000000000000000000000000000000000000000000000000000000000000000000000000000000000000000000000000002500
220000000000000000000000000000000000000000000000000000000000000000000000000000000000000000000000000000000000000000000000000000000000000000000000000000000000000000000000000000000000000000000000000000000000000000000000000000000000000000001500
323500000000000000000000000000000000000000000000000000000000000000000000000000000000000000000000000000000000000000000000000000000000000000000000000000000000000000000000000000000000000000000000000000000000000000000000000000000000000000002500
002500000000000000000000000000000000000000000000000000000000000000000000000000000000000000000000000000000000000000000000000000000000000000000000000000000000000000000000000000000000000000000000000000000000000000000000000000000000000000002500
002500000000000000000000000000000000000000000000000000000000000000000000000000000000000000000000000000000000000000000000000000000000000000000000000000000000000000000000000000000000000000000000000035252525000000000000000000000000000000003500
001500000000002535000000000000000000000000000000000000000000000000000000000000000000000035152500000015000025152500353500000000000000000000000000000000000000000000000000000025000025250015153525000000000000000000000015000000000000000000001500
001011111112000000150010111112001011111200000035001012001500150000101200101111120025001500000000000000000000000000000010120000101200101111111111111111111111111112001011111200000000000000000000000000000000000000000000000000000010111112003500

image image:library
