133131313131313131353131313131313131311421212121212121212121212121212121212121212121212121212121212121212121212121212121212121212121212121212121212121212121212121212121212121212121212121212121212121212121212121212121212121212121212121212121
220000000000004071717200000000000000002021212121212121212113313131313131313131313131313131313131313131313131313131313131313131313131313131313131313131313131313131313131313131313131313131313131313131313131313131313131313131313114212121212121
220010111111125300000000000000001012002021212121212121212122000000000000000000000000000000000000000000000000000000000000000000000000000000000000000000000000000000000000000000000000000000000000000000000000000000000000000000000020212121212121
220030313131325300000000000000002022002021212121212121212122000000000000000000000000000000000000000000000000000000000000000000000000000000000000000000000000000000000000000000000000000000000000000000000000000000000000000000000020212121212121
220070717171716210111112001011112422003031313131353131313132000000000000000000000000000000000000000000000000000000000000000000000000000000000000000000000000000000000000000000000000000000000000000000000000000000000000000000000020212121212121
220010111111120020212122003031313132000000000000430000000000000000101111111111111111111111111111111111111111111111111111111111111111111111111111111112250015002500150025002500150025001500150000001500150025002500150025002500000020212121212121
220020133131320030313132000000000000707171717171617171717171714200202121212121212121212121212121212121212121212121212121212121212121212121212121212122001500150015001500150015001500150025001500150015002500150025001500250000000020212121212121
220020220000000000000000001011111112000000000000000000000000005300202121212121212121212121212121212121212121212121212121212121212121212121212121212122150015001500150015001500250025001500150000002500150025001500250015001500000020212121212121
220030320000000000000000003031313132001011111111111111111112005300202121212121212121212121212121212121212121212121212121212121212121212121212121212122002500150025002500150015001500150015001500150025001500250025001500150000000020212121212121
220000000000000000430000000000000000002021212121212121212122005300202121212121212121212121212121212121212121212121212121212121212121212121212121212122250015002500250015001500250015001500150000002500150015002500150025002500000020212121212121
231111111111111200530010111111111111112421212121212121212122005300202121212121212121212121212121212121212121212121212121212121212121212121212121212122001500150015001500250015002500150015001500150025002500150015002500150000000020212121212121
212121212121212200530020212121212121212121212121212121212122005300202121212121212121212121212121212121212121212121212121212121212121212121212121212122250025001500150015001500250015002500000000000000000025001500150015002500000020212121212121
212121212121212200530020212121212121212121212121212121212122005300202121212121212121212121212121212121212121212121212121212121212121212121212121212122001500150015001500250015001500150000000000000000002500150025001500150000000020212121212121
212121212121212200530020212121212121212121212121212121212122005300202121212121212121212121212121212121212121212121212121212121212121212121212121212122250015001500250015001500250025001500000000000000000015001500150015001500000020212121212121
212121212121212200530020212121212121212121212113313131313132005300202121212121212121212121212121212121212121212121212121212121212121212121212121212122001500150015002500150015001500150025001500250015001500250015001500250000000020212121212121
212121212121212200530020212121212121212121212122000000000000005300202121212121211331313131313131313131313131313131313131313131313131313131313131313132150025001500150025001500250015001500150015001500150025002500150025002500000020212121212121
212121212121212200530020212121212121212121212122004071717171715200202121212121212200000000000000000000000000000000000000000000000000000000000000000000000000000000000000000000000000000000000000000000000000000000000000000000000020212121212121
212113313131313200530030313131142121212121212122005300000000005300202121212121212200000000000000000000000000000000000000000000000000000000000000000000000000000000000000000000000000000000000000000000000000000000000000000000000020212121212121
212122000000000000630000000000202121212121212122005300000000005300202121212121212200000000000000000000000000000000000000000000000000000000000000000000000000000000000000000000000000000000000000000000000000000000000000000000000020212121212121
212122000000000000000000000000303131313114212122005300000000005300202121212121212200000010111111111111111111111111111111111111111111111111111112000000101111111111111111111111111111111111111111111111111111111111111111111200000020212121212121
212122000000000000000000000000000000000020212122005071717171716200202121212121212200000020212121212121212121212121212121212121212121212121212122000000202121212121212121212121212121212121212121212121212121212121212121212200000020212121212121
212122000000000000000000000000000000000020212122005300000000000000202121212121212200000020212121212121212121212121212121212121212121212121212122000000202121212121212121212121212121212121212121212121212121212121212121212200000020212121212121
212122000000000000000000000000101200000020212122005300101111111111242121212121212200000020212121212121212121212121212121212121212121212121212122000000202121212121212121212121212121212121212121212121212121212121212121212200000020212121212121
212122000000000000000000000000202200000020212122005300202121212121212121212121212200000020212121212121212121212121212121212121212121212121212122000000202121212121212121212121212121212121212121212121212121212121212121212200000020212121212121
212122000000000000000000000000202200000020212122005300202121212121212121212121212200000020212121212121212121212121212121212121212121212121212122000000202121212121212121212121212121212121212121212121212121212121212121212200000020212121212121
212123111111111111111111111111242200000020212122005300202121133131313131313131313200000030313131313131313131313131313131313131313131313114212122000000202121212121212121212121212121212121212121212121212121212121212121212200000020212121212121
212121212121212121212121212121212200000020212122005300202121220000000000000000000000000000000000000000000000000000000000000000000000000020212122000000202121212121212121212121212121212121212121212121212121212121212121212200000020212121212121
212121212121212121212121212121212200000020212122005300202121220000000000000000000000000000000000000000000000000000000000000000000000000020212122000000202121212121212121212121212121212121212121212121212121212121212121212200000020212121212121
212121212121212121212121212121212200000020212122005300202121220000101111111111111111111111111111111111111111111111111111111111111112000020212122000000202121212121212121212121212121212121212121212121212121212121212121212200000020212121212121
212121212121212121212121212121212200000020212122005300202121220000202121212121212121212121212121212121212121212121212121212121212122000020212122000000202121212121212121212121212121212121212121212121212121212121212121212200000020212121212121
212121212121212121212121212121212200000020212122005300202121220000202121212121212121212121212121212121212121212121212121212121212122000020212122000000202121212121212121212121212121212121212121212121212121212121212121212200000020212121212121
212121212121212121212121212121212200000020212122005300202121220000202121133131313131313131313131313131313131313131313131313114212122000020212122000000202121212121212121212121212121212121212121212121212121212121212121212200000020212121212121
212121212121212121212113313131313200000030311422005300202121220000202121220000000000000000000000000000000000000000000000000020212122000020212122000000202121212121212121212121212121212121212121212121212121212121212121212200000020212121212121
212121212121212121212122000000000000000000002022005300202121220000202121220010111111111111111111111111111111111111111111120020212122000020212122000000202121212121212121212121212121212121212121212121212121212121212121212200000020212121212121
212121212121212121212122000000000000000000002022005300202121220000202121220020212121212121212121212121212121212121212121220020212122000020212122000000202121212121212121212121212121212121212121212121212121212121212121212200000020212121212121
212121212121212121212122000000000000000000002022005300202121220000202121220020212121212121212121212121212121212121212121220020212122000020212122000000303131313131313131313131313131313131313131313131313131313131313131313200000030313131313114
212121212121212121212122000000000000000000002022005300202121220000202121220020212113313131313131313131313131313131142121220020212122000020212122000000000000000000000000000000000000000000000000000000000000000000000000000000000000000000000020
212121212121212121212122000000000000000000002022005300202121220000202121220020212122000000000000000000000000000000202121220020212122000020212122000000000000000000000000000000000000000000000000000000000000000000000000000000000000000000000020
212121212121212121212122000000000000000000002022005300202121220000202121220020212122001011111111111111111112001500202121220020212122000020212122000000000000000000000000000000000000000000000000000000000000000000000000000000000000000000000020
212121212121212121212122000000000000000000002022005300202121220000202121220020212122002021212121212121212122000000202121220020212122000020212122000000101111111111111111111111111111111111111111111111111111111111111111111111111111111200000020
212121212121212121212123111200001011111111112422005300202121220000202121220020212122002021212121212121212123111111242121220020212122000020212122000000202121212121212121212121212121212121212121212121212121212121212121212121212121212200000020
212121212121212121212121212200002021212121212122005300202121220000202121220020212122002021212121212121212121212121212121220020212122000020212122000000202121212121212121212121212121212121212121212121212121212121212121212121212121212200000020
212121212121212121212121212200002021212121212122005300202121220000202121220020212122002021212121212121212121212121212121220020212122000020212122000000202121212121212121212121212121212121212121212121212121212121212121212121212121212200000020
212121212121212121212121212200002021212121212122005300202121220000202121220020212122003031313131313131313131313131313131320020212122000020212122000000202121212121212121212121212121212121212121212121212121212121212121212121212121212200000020
212121212121212121212121212200002021212121212122005300202121220000202121220020212122000000000000000000000000000000000000000020212122000020212122000000202121212121212121212121212121212121212121212121212121212121212121212121212121212200000020
212121212121212121212121212200002021212121212122005300202121220000202121220020212123111111111111111111111111111111111111111124212122000020212122000000202121212121212121212121212121212121212121212121212121212121212121212121212121212200000020
212121212121212121212121212200002021212121212122005300202121220000202121220020212121212121212121212121212121212121212121212121212122000020212122000000202121212121212121212121212121212121212121212121212121212121212121212121212121212200000020
211331313131313131313131313200002021212121212122005300202121220000202121220020212121212121212121212121212121212121212121212121212122000020212122000000202121212121212121212121212121212121212121212121212121212121212121212121212121212200000020
212200000000000000000000000000002021212121212122005300202121220000202121220030313131313131313131313131313131313131313131313131313132000020212122000000202121212121212121212121212121212121212121212121212121212121212121212121212121212200000020
212200000000000000000000000000002021212121212122005300202121220000202121220000000000000000000000000000000000000000000000000000000000000020212122000000202121212121212121212121212121212121212121212121212121212121212121212121212121212200000020
212200001011111111111111111111112421212121212122005300202121220000202121220010111111111111111111111111111111111111111111111111111112000020212122000000202121212121212121212121212121212121212121212121212121212121212121212121212121212200000020
212200003031313131313131311421212121212121212122005300202121220000202121220020212121212121212121212121212121212121212121212121212122000020212122000000202121212121212121212121212121212121212121212121212121212121212121212121212121212200000020
212200000000000000000000002021212121212121212122005300202121220000202121220020212121212121212121212121212121212121212121212121212122000020212122000000202121212121212121212121212121212121212121212121212121212121212121212121212121212200000020
212200000000000000000000002021212121212121212122005300202121220000202121220020211331313131313131313131313131313131313131313114212122000020212122000000202121212121212121212121212121212121212121212121212121212121212121212121212121212200000020
212200000000000000000000002021212121212121212122005300202121220000202121220020212200000000000000000000000000000000000000000020212122000020212122000000202121212121212121212121212121212121212121212121212121212121212121212121212121212200000020
212200000000000000000000002021212121212121212122005300202121220000202121220020212200101111111111111111111111111111111111120020212122000020212122000000202121212121212121212121212121212121212121212121212121212121212121212121212121212200000020
212200000000000000000000003031313131313131313132005300202121220000202121220020212200201331313131313131313131313131313114220020212122000020212122000000202121212121212121212121212121212121212121212121212121212121212121212121212121212200000020
212200000000000000000000000000000000000000000000005300202121220000202121220020212200202200000000000000000000000000000020220020212122000020212122000000202121212121212121212121212121212121212121212121212121212121212121212121212121212200000020
212200000000000000000000000000000000101200000000005300202121220000202121220020212200202200101111111111111111111111120020220020212122000020212122000000303131313131313131313131313131313131313131313131313131313131313131313131313131313200000020
212200000000000000000000001012000000303200001012005300202121220000202121220020212200202200202121212121211331313114220020220020212122000020212122000000000000000000000000000000000000000000000000000000000000000000000000000000000000000000000020
212200000000000000000000002022000000000000002022005300202121220000202121220020212200202200202121212121212200000020220020220020212122000020212122000000000000000000000000000000000000000000000000000000000000000000000000000000000000000000000020
212311111111111111111111112422000010111111112422005300202121220000202121220030313200202200303131313131313200150020220020220020212122000020212122000000000000000000000000000000000000000000000000000000000000000000000000000000000000000000000020
212121212121212121211331313132000020212121212122005300202121220000202121220000000000202200000000000000000000000020220020220020212122000020212122000000101111111111111111111111111111111111111112000010111111111111111111111111111111111111111124
212121212121212121212200000000000020212121212122005300202121220000202121220010111111242311111111111111111111111124220020220020212122000020212122000000202121133131313131313131313131313131311422000020133131313131313131313131313131311421212121
212121212121212121212240720000000020212121212122005300202121220000202121220020211331313131313131313131313131313131320020220020212122000020212122000000202121220000000000000000000000000000002022000020220000000000000000000000000000002021212121
211331313131313114212253001011111124212121212122005300202121220000202121220020212200000000000000000000000000000000000020220020212122000020212122000000202121220000000000000000000000000000002022000020220000000000000000000000000000002021212121
212200000000000020212253002021212121212121212122005300202121220000202121220020212200101111111111111111111111111111111124220020212122000020212122000000202121220000000000000000000000000000002022000030320000000000000000000000000000002021212121
212200000000150030313253002021212121212121212122005300202121220000202121220020212200303131313131313131313131313131313131320020212122000020212122000000202121220000000000000000000000000000002022000000000000000000000000000000000000002021212121
212200000000000000000053002021133131313131311422005300202121220000202121220020212200000000000000000000000000000000000000000020212122000020212122000000202121220000000000000000000000000000002022000010120000000000000000000000000000002021212121
212200000000000010111253002021220000000000002022005300202121220000202121220020212311111111111111111111111111111111111111111124212122000020212122000000202121220000000000000000000000000000002022000020220000000000000000000000000000002021212121
212200000000000020212253002021220000000000002022005300202121220000202121220020212121212121212121212121212121212121212121212121212122000020212122000000202121220000000000000000000000000000003032000020220000000000000000000000000000002021212121
212311111111111124212253003031320000101200002022005300202121220000202121220020212121212121212121212121212121212121212121212121212122000020212122000000202121220000000000000000000000000000000000000020231111111111111111111111111111112421212121
211331313131313114212253000000000000303200002022005300202121220000202121220030313131313131313131313131313131313131313131313131313132000020212122000000202121220000000000000000000000000000001012000020133131313131313131313131313131311421212121
212200000000000020212253001011120000000000002022005300202121220000202121220000000000000000000000000000000000000000000000000000000000000020212122000000202121220000000000000000000000000000002022000020220000000000000000000000000000002021212121
212200000000000030313253002021220000000000002022005300202121220000202121220000000000000000000000000000000000000000000000000000000000000020212122000000202121220000000000000000000000000000002022000020220000000000000000000000000000002021212121
212200000000000000000053002021231111111111112422005300202121220000202121231111111111111111111111111111111111111111111111111111111111111124212122000000202121231111111111111111111111111111112422000030320000000000000000000000000000002021212121
212200001500000010111253002021212121212121212122005300202121220000202121212121212121212121212121212121212121212121212121212121212121212121212122000000202121133131313131313131313131313131311422000000000000000000000000000000000000002021212121
212200000000000020212253002021133131313131311422005300202121220000202121212121212121212121212121212121212121212121212121212121212121212121212122000000202121220000000000000000000000000000002022000010120000000000000000000000000000002021212121
212311111111111124212253003031320000000000002022005300202121220000303131313131313131313131313131313131313131313131313131313131313131313131313132000000202121220000000000000000000000000000002022000020220000000000000000000000000000002021212121
211331313131313114212253000000000000000000002022005300202121220000000000000000000000000000000000000000000000000000000000000000000000000000000000000000202121220000000000000000000000000000003032000020220000000000000000000000000000002021212121
212200000000000020212253001011120000101200002022005300202121220000000000000000000000000000000000000000000000000000000000000000000000000000000000000000202121220000000000000000000000000000000000000020231111111111111111111111111111112421212121
212200000000000030313253002021220000303200002022005300202121220000000000000000000000000000000000000000000000000000000000000000000000000000000000000000202121220000000000000000000000000000001012000020133131313131313131313131313131311421212121
212200000015000000000053002021220000000000002022005300202121231111111111111111111111111111111111111111111111111111111111111111111112001011111111111111242121220000000000000000000000000000002022000020220000000000000000000000000000002021212121
212200000000000010111253002021220000000000002022005300202121212121212121212121212121212121212121212121212121212121212121212121212122003031313131313131142121220000000000000000000000000000002022000020220000000000000000000000000000002021212121
212200000000000020212253002021231111111111112422005300202121212121212121212121212121212121212121212121212121212121212121212121212122000000000000000000202121231111111111111111111111111111112422000030320000000000000000000000000000002021212121
212311111111111124212253002021212121212121212122005300303131313131313131313131313131313131313131313131313131313131313131313131142123111111111111111200202121133131313131313131313131313131311422000000000000000000000000000000000000002021212121
212113313131313131313253002021212121212121212122005300000000000000000000000000000000000000000000000000000000000000000000000000202121212121212121212200202121220000000000000000000000000000002022000010120000000000000000000000000000002021212121
212122000040717171717162002021212121212121212122006071717171717171717171717171717171717171717171717171717171717171717171714200303131313131313131313200202121220000000000000000000000000000002022000020220000000000000000000000000000002021212121
212122000053000000000000002021212121212121212122000000000000000000000000000000000000000000000000000000000000000000000000005300000000000000000000000000202121220000000000000000000000000000003032000020220000000000000000000000000000002021212121
212122000053001011111111112421212121212121212123111111111111111111111111111111111111111111111111111111111111111111111112005300101112001011111111111111242121220000000000000000000000000000000000000020231111111111111111111111111111112421212121
212122000053002021212121212121212121212121212121212121212121212121212121212121212121212121212121212121212121212121212122005300202122002021212121212121212121220000000000000000000000000000001012000020133131313131313131313131313131311421212121
212122000053002021212121212121212121212121212121212121212121212121212121212121212121212121212121212121212121212121212122005300202122002021212121212121212121220000000000000000000000000000002022000020220000000000000000000000000000002021212121
212122000053002021212121212121212121212121212121212121212121212121212121212121212121212121212121212121212121212121212122005300202122002021212121212121212121220000000000000000000000000000002022000020220000000000000000000000000000002021212121
212122000053002021212121212121212121212121212121212121212121212121212121212121212121212121212121212121212121212121212122005300202122002021212121212121212121231111111111111111111111111111112422000030320000000000000000000000000000002021212121
212122000053002021212121212121212121212121212121212121212121212121212121212121212121212121212121212121212121212121212122005300202122002021212121212121212121212121212121212121212121212121212122000000000000000000000000000000000000002021212121
212122000053002021212121212121212121212121212121212121212121212121212121212121212121212121212121212121212121212121212122005300202122002021212121212121212121212121212121212121212121212121212122000010120000000000000000000000000000002021212121
212122000053002021212121212121212121212121212121212121212121212121212121212121212121212121212121212121212121212121212122005300202122002021212121212121212121212121212121212121212121212121212122000020220000000000000000000000000000002021212121
212122000053002021212121212121212121212121212113313131313131313131313131313131313131313131313131313131313131313114212122005300202122003031313131313131313131313131313131313131313131313131313132000020220000000000000000000000000000002021212121
212122000053002021212121212121212121212121212122000000000000000000000000000000000000000000000000000000000000000020212122005300202122000000000000000000000000000000000000000000000000000000000000000020231111111111111111111111111111112421212121
212122000053002021212121212121212121212121212122000015000015000015000025000015000015000025000015000015000015000020212122005300202123111111111111111111111111111111111111111111111111111111111112000020212121212121212121212121212121212121212121
212122000053002021212121212121212121212121212122000000000000000000000000000000000000000000000000000000000000000020212122005300202121212121212121212121212121212121212121212121212121212121212122000020212121212121212121212121212121212121212121
212122000053002021212121212121212121212121212122000000000000000000000000000000000000000000000000000000000000000020212122005300202121212121212121211331313131313131313131313131313131142121212122000030313131313131313131313131313131313131142121
212122000053002021212121212121212121212121212122000025000015000025000015000025000025000015000015000025000025000020212122005300202121212121212121212200000000000000000000000000000000202121212122000000000000000000000000000000000000000000202121
212122000053002021212121212121212121212121212122000000000000000000000000000000000000000000000000000000000000000020212122005300202121212121212121212200101200101200101200101200101200202121212122000000000000000000000000000000000000000000202121
212122000053002021212121212121212121212121212122000000000000000000000000000000000000000000000000000000000000000020212122005300202121212121212121212200303200303200303200303200303200202121212123111111111111111111111111111111111111120000202121
212122000053002021212121212121212121212121212122000025000025000025000015000015000015000025000025000015000025000020212122005300202121212121212121212200000000000000000000000000000000202121212121212121212121212121212121212121212121220000202121
212122000053002021212121212121212121212121212122000000000000000000000000000000000000000000000000000000000000000020212122005300202121212121212121212200101200101200101200101200101200202121212121212121212121212121212121212121212121220000202121
212122000053002021212121212121212121212121212122000000000000000000000000000000000000000000000000000000000000000020212122005300202121212121212121212200303200303200303200303200303200202121212121212121212121212121212121212121212121220000202121
212122000053002021212121212121212121212121212122000025000015000015000025000025000015000025000025000015000025000020212122005300202121212121212121212200000000000000000000000000000000202121212121212121212121212121212121212121212121220000202121
212122000053002021212121212121212121212121212122000000000000000000000000000000000000000000000000000000000000000020212122005300202121212121212121212200101200101200101200101200101200202121212121212121212121212121212121212121212121220000202121
212122000053002021212121212121212121212121212122000000000000000000000000000000000000000000000000000000000000000020212122005300202121212121212121212200303200303200303200303200303200202121212121212121212121212121212121212121212121220000202121
212122000053002021212121212121212121212121212122000015000025000015000015000025000015000015000025000025000015000020212122005300202121212121212121212200000000000000000000000000000000202121211331313131313131313131313131313131142121220000202121
212122000053002021212121212121212121212121212122000000000000000000000000000000000000000000000000000000000000000020212122005300202121212121212121212200101111111111111111111111111111242121212200000000000000000000000000000000202121220000202121
212122000053003031313131313131313131313131313132000000000000000000000000000000000000000000000000000000000000000030313132005300303131313131313131313200202121212121212121212121212121212121212200430000000000000000000000000000202121220000202121
212122000053000000000000000000000000000000000000000015000015000015000015000025000025000025000015000015000025000000000000006300000000000000000000000000202121212121212121212121212121212121212200530010111111111111111111120000202121220000202121
212122000053000000000000000000000000000000000000000000000000000000000000000000000000000000000000000000000000000000000000000000000000101111111111111111242121212121212121212121212121212121212200530020212121212121212121220000202121220000202121
212122000060717171717171717171717171717171717171717171717171717171717171717171717171717171717171717171717171717171717172001500150000303131313131313131313131313131313131313131313131313131313200530020212121212121212121220000202121220000202121
212122000000000000000000000000000000000000000000000000000000000000000000000000000000000000000000000000000000000000000000000000000000000000000000000000000000000000000000000000000000000000000000530020212121212121212121220000303131320000202121
212123111111111111111111111111111111111111111111111111111111111111111111111111111111111111111111111111111111111111111112000000007071717171717171717171717171717171717171717171717171717171717171620020212121212121212121220000000000000000202121
212121212121212121212121212121212121212121212121212121212121212121212121212121212121212121212121212121212121212121212122000000000000000000000000000000000000000000000000000000000000000000000000000020212121212121212121220000000000000000202121
212121212121212121212121212121212121212121212121212121212121212121212121212121212121212121212121212121212121212121212123111111111111111111111111111111111111111111111111111111111111111111111111111124212121212121212121231111111111111111242121

image image:library
hero @4,4
message @9,0 strings:dialogue (u16)1 0 0
message @24,4 strings:dialogue (u16)2 0 0
