4475757575757575754575757575754575757575757575754575757575757575757545757575757575757546
5704050303000402055704050300035705040302000104005700020004000101000057017071717171714257
5701040503010005006701010100035704070503060007045700013600020300050457040404040505035357
57000104030401020103040203000557050103050a0402005702020a00000001070257050206010304265357
57050204010001040047040201032757010300020417020557020405000701030503570102020503040a5357
57000404010003000557050300000a5701043701000401055706030005050006040357042702033604055357
5475757575757575756575754575756605370a02014475756603050501010202010257020005030001056357
5705030401040505040302005700010504040300045702030001260207000601170457040400000300000257
5701270517043700260037016702030401000104046704000305020501000a05004465757575757575757556
5700030405010105040004021011111111111111111111120536050702170026015704040105030202030457
5700070237031600260026022021212121212121212121220402050002000304005700070516000301030157
57040303030204010a00050020212121212121212121212274757575757575757556040a0001030205020457
5705370216010604060026002021212121212121212121220205040402040400055706040404040543010157
5703040102030304040105002021212121212121212121220207041602360027015700010702044062010457
547575757575757575757576202121212121133131313132050a020301010100035702050401055301010257
5740717171717171717171422021212121212270717171714201160316040600005705260326005304370557
5753020201033605260106532021212121212203060206026071717171717172005705050101055303020557
5753050304030303010200533031313131313203020303013705270400020103045703010101055303030557
5753020502070306053605530147040103004701040201050203050544757575756575757546015302020257
5753040501010204010a00530557022604056475757575460207050557020300050102000154765374757556
5753030317052701270036630257040203260000160500570401040457000437000702370157036071420257
57530005000000030500000101570203000a01000002045700030204570005040002000a0457050700530357
5753020336052605370300447565757575757575757575657546010057032700014302030457040a02630457
5753010301010203020403570001020003020500040105020357000357020302025305020157010202050157
5753000016042603260000570117050704370107040704360364757565757575765374757565757575757556
576304020a020505040000570003040a03040500040402050401050301030305025071717204000101010457
6475757575757575757575660100370127052604370106033702260206003603005301000203030304050057
1111124304020002040403010002030300020104010304040402040503030204005300060437010601060057
2121225300030426050603070226032700170207020700360537020704360417025301020305050303030457
2121225300030300040505030005030001020302010005050400040201000305006042040227023604160057
2121225300022600060336053701360236002703260206031600160017030601010453010200010005000157
2121225303050305020501000302050001050400020300000505000103040305034062010417001703060257
2121225305030501020102020501030302050304020205407171717171717171716202000201020404020057
2121226071717171717171717171717171717171717171520403050505000001030002000104020104010267
2121231111111111111111111111111111111111111112531011111111111111111111111111111111111111
2121212121212121212121212121212121211331352532532021212121212121212121212121212121212121
2121212121212121212121212121212121212270717171622021212121212121212121212121212121212121
2121212121212121212121212121212121212311111111112421212121212121212121212121212121212121
2121212121212121212121212121212121212121212121212121212121212121212121212121212121212121
2121212121212121212121212121212121212121212121212121212121212121212121212121212121212121

door @20,35 map:library @9,3 0x0000
image image:cemetery
song song:worms_lair
battlebg (u16)3
sprite sprite:disemvoweller @5,3 flag:book1 0x000000
battle battle:skeleton 0x0006
battle battle:eviltwin 0x0003
sprite sprite:kitchen @12,3 0x02020202
door @14,5 map:bonezone @14,5 0 0
door @20,3 map:bonezone @20,3 0 0
door @18,6 map:bonezone @18,6 0 0
door @27,3 map:bonezone @27,3 0 0
door @30,8 map:bonezone @30,8 0 0
door @41,4 map:bonezone @41,4 0 0
door @8,11 map:bonezone @8,11 0 0
door @35,11 map:bonezone @35,11 0 0
door @25,14 map:bonezone @25,14 0 0
door @9,19 map:bonezone @9,19 0 0
door @4,25 map:bonezone @4,25 0 0
door @17,21 map:bonezone @17,21 0 0
door @15,25 map:bonezone @15,25 0 0
door @35,21 map:bonezone @35,21 0 0
door @39,22 map:bonezone @39,22 0 0
