1331313131313131311413313131313131313131313131313131313131313131313131313131313131313114
2205010302040401003032030103010003020105030204000503010304030205040101040202020105050520
2201040503010005030000030100050402000102000101050105020400020300030304020203050402040220
2204010403040102040103000304050402030304000005370400050502000003010302020206010302010420
2205050001000104030205010200000005030002020301010004030200070101010104000405030003000320
2201430204050004041012040303000004033602050502010027030005050006040370420203030204050420
2312531011111111112422050101030501040401021701020104050501010202010401530005270305030120
1332533014133131313132040504020201040001040303020205260207011703370203530100020302020020
2201530320220200030104000200050204040505010001170405020501020205020403607171717142020520
2201530020220504050505040502050002030505000102020136050702270316020701030402040453010120
2204530120220101010503010101010101050405010005000005020403020402050404070216000053020220
2204530220220001360516010204020504010700010203704201040016050705370103050501030253050520
2240620420220202050005010103360505000504020403016042020104040300040126050304040053040520
2253000420220005070316010301030026050500270501000460420103020405050104010702044062000420
2253101124220002010403052600010303000001010405020101607171717171714203040502025305000520
2253201331320300270016010200050500040001030101000502040203020405015305030203035303000520
2253202203000101020504000206001600270536042701060036033703160507045305050001005300040120
2253202201050202707171420003020102010103020502000103000301020400026301010505005303000520
2253202204010401040501530400360216020605070226040604060216032603010104030201015301020020
2253202203270406051700530501040005030403020505010400050303030100040200020302406203050120
2253202203040005050302507171717171717142020105030005010704360437010000000405530505040120
2253202201060017040600630205050404020060720037017042040303020304010105010402530300050020
2253202204010501040203030501000300000204020403010353050416052700014301030503530305000520
2253202202370006002705050401050400020001020104040553030301010100055304010240620505010220
2253202200000200000102430317010600370107040704360560720570717172035302024062010401020220
2253202311124071717171620403050304040500040402050502010300040204045071716204020105010320
2253303114225303010204040400070216052604370106033702260206003603005304020205030501050320
2260714220225303030201000502030300020104010304040402040503030204005301040304040304050220
2311125320225303050603070226032700170207020700360537020704360417025300030005040300010320
2121225320225304000505030005030001020302010005050400040201000305006042040205050502010320
2121225320225304060336053701360236002703260206031600160017030601010453010204040105000220
2121225320225301010005000202030403020504050201000505000103040305034062010303030404000520
2121225320226071717171717171717171717171717171417171717171717171716202000405050105010120
2121225320220200000404020201020201040202000203530403050505000001030002000104020104010520
2121225320231111111111111111111111111111111112531011111111111111111111111111111111111124
2121225330313131313131313131313131313131352532532021212121212121212121212121212121212121
2121226071717171717171717171717172087071717171622021212121212121212121212121212121212121
2121231111111111111111111111111111111111111111112421212121212121212121212121212121212121
2121212121212121212121212121212121212121212121212121212121212121212121212121212121212121
2121212121212121212121212121212121212121212121212121212121212121212121212121212121212121

door @20,35 map:library @9,2 0x0000
image image:cemetery
song song:worms_lair
battlebg (u16)3
sprite sprite:disemvoweller @5,3 flag:book1 0x000000
battle battle:skeleton 0x1000
battle battle:eviltwin 0x0400
sprite sprite:kitchen @18,14 0x02020202
flagtile @17,36 flag:book1 0
