21212121212121212121212121212121212121212121212121212121212121212121212121212121
21212121212121212121212121212121212121212121212121212121212121212121212121212121
21212121212121212121212121212121212121212121212121212121212121212121212121212121
21212121212121212121212121212121212121212121212121212121212121212121212121212121
21212121212121212121212121212121212121212121212121212121212121212121212121212121
21212121212121212121212121212113313103043131142121212121212121212121212121212121
21212121212121212121212121212122000000000000202121212121212121212121212121212121
21212121212121212121212121212122000000330000202121212121212121212121212121212121
2121212121212121212121211331313200000000000020133108090a0b0c03041421212121212121
21212121212121212121212122000000003300003300202200000000000000002021212121212121
212121212121212121212121220010120000000000002022000d0f00000d0f002021212121212121
21212121212121212121212122002022000000000000202200000000000000002021212121212121
21212121212121212121212122002023111111111111242200000000000000002021212121212121
21212121212121212121212122002013313103043131142201101111111111112421212121212121
21211331310304313114212122002022000000000000202200202121212121212121212121212121
21212200000000000020212122002022000d1f0e0f00202201303131142121212121212121212121
21212200000000000020212122002022000000000000202200000000202121212121212121212121
21212200330000330020212122002022000d0e1f0f00202200000000202121212121212121212121
21212200003333000020212122002022000000000000202200000000202121212121212121212121
21212200330000330020212122002023111200101111242200101111242121212121212121212121
21212200000000000020212122003031313200303131313200202121212121212113313431142121
21212200000000000020212122000000000000000000000000202121133131311422004300202121
21212311120010111124212123111111111111111111111201202121220000002022005300202121
21212121220030313131313131313131313131313131313200303131320000002022005300202121
21212121220000000000000000000000000000000100010000000100000000002022005300202121
21212121231111111111111111111111111111111111111200101111111111112422005300202121
21212121212121133131313131313131313131313131313201303131313131313132005300202121
21212121212121220000000000000000000000000000000000000000000000000000005300202121
21212121212121220000707171717171717171717171717171717171717171717171716200202121
21212121212121220000000000000000000000000000000000000000000000000000000000202121
21212121212121220010111111111111111112001011111111111111111111120010111111242121
2121133103043132003006071413313103043200301a1b1c14133131030431320030181931142121
21212200000000000000161720220000000000000000000020220000000000000000000000202121
21212200000000000000000020220000000000000000000020220033000000000000003300202121
212122000d1e0f000d0e0f0020220010120010120010120020220000000000000000000000202121
21212200000000000000000020220030320030320030320020220033000000000000003300202121
21212200000000000000000020220000000000000000000020220000000000000000000000202121
21212311111111111111111124231111111111111111111124231111111111111111111111242121
21212121212121212121212121212121212121212121212121212121212121212121212121212121
21212121212121212121212121212121212121212121212121212121212121212121212121212121

image image:lab
song song:scholar
battlebg (u16)1
door @35,20 map:library @3,12 0x0000
sprite sprite:scholar @30,23 flag:book2 0x000000
sprite sprite:kitchen @26,17 0x80201004
battle battle:coyote 0x0001
battle battle:skeleton 0x0003
battle battle:eyeball 0x0003
flagtile @26,24 flag:lablock1 0
flagtile @24,13 flag:lablock2 0
flagtile @24,22 flag:lablock3 0
flagtile @24,15 flag:lablock4 0
flagtile @20,24 flag:lablock5 0
flagtile @22,24 flag:lablock6 0
flagtile @24,26 flag:lablock7 0
toggle @31,8 flag:lablock1 0
toggle @19,5 flag:lablock2 0
toggle @6,14 flag:lablock3 0
toggle @19,13 flag:lablock4 0
toggle @5,31 flag:lablock5 0
toggle @17,31 flag:lablock6 0
toggle @29,31 flag:lablock7 0
sprite sprite:archaeologist @34,32 0x00000000
sprite sprite:kitchen @6,19 0x04048080
message @11,32 strings:dialogue (u16)49 0 0
sprite sprite:englishprof @21,32 0x00000000
