21212121212121212121212121212121212121212121212121212121212121212121212121212121
21212121212121212121212121212121212121212121212121212121212121212121212121212121
21212121212121212121212121212121212121212121212121212121212121212121212121212121
21212121212121212121212121212121212121212121212121212121212121212121212121212121
21212121212121212121212121212121212121212121212121212121212121212121212121212121
21212121212121212121212121212113313103043131142121212121212121212121212121212121
21212121212121212121212121212122000000000000202121212121212121212121212121212121
21212121212121212121212121212122000000330000202121212121212121212121212121212121
21212121212121212121212113313132000000000000201331313103043131311421212121212121
21212121212121212121212122000000003300003300202200000000000000002021212121212121
21212121212121212121212122001012000000000000202200000000000000002021212121212121
21212121212121212121212122002022000000000000202200000000000000002021212121212121
21212121212121212121212122002023111111111111242200000000000000002021212121212121
21212121212121212121212122002013313103043131142201101111111111112421212121212121
21211331310304313114212122002022000000000000202200202121212121212121212121212121
21212200000000000020212122002022003300003300202201303131142121212121212121212121
21212200000000000020212122002022000000000000202200000000202121212121212121212121
21212200330000330020212122002022000000000000202200000000202121212121212121212121
21212200003333000020212122002022000000000000202200000000202121212121212121212121
21212200330000330020212122002023111200101111242200101111242121212121212121212121
21212200000000000020212122003031313200303131313200202121212121212113313431142121
21212200000000000020212122000000000000000000000000202121133131311422000000202121
21212311120010111124212123111111111111111111111201202121220000002022000000202121
21212121220030313131313131313131313131313131313200303131320000002022000000202121
21212121220000000000000000000000000000000100010000000100000000002022000000202121
21212121231111111111111111111111111111111111111200101111111111112422000000202121
21212121212121133131313131313131313131313131313201303131313131313132000000202121
21212121212121220000000000000000000000000000000000000000000000000000000000202121
21212121212121220000000000000000000000000000000000000000000000000000000000202121
21212121212121220000000000000000000000000000000000000000000000000000000000202121
21212121212121220010111111111111111112001011111111111111111111120010111111242121
21211331030431320030313114133131030432003031313114133131030431320030313131142121
21212200000000000000000020220000000000000000000020220000000000000000000000202121
21212200000000000000000020220000000000000000000020220033000000000000003300202121
21212200000000000000000020220010120010120010120020220000000000000000000000202121
21212200330000330000330020220030320030320030320020220033000000000000003300202121
21212200000000000000000020220000000000000000000020220000000000000000000000202121
21212311111111111111111124231111111111111111111124231111111111111111111111242121
21212121212121212121212121212121212121212121212121212121212121212121212121212121
21212121212121212121212121212121212121212121212121212121212121212121212121212121

image image:lab
song song:scholar
battlebg (u16)1
door @35,20 map:library @3,12 0x0000
sprite sprite:scholar @30,23 flag:book2 0x000000
sprite sprite:kitchen @26,17 0x80201004
battle battle:coyote 0x0001
battle battle:skeleton 0x0003
battle battle:eyeball 0x0003
flagtile @26,24 flag:lablock1 0
flagtile @24,13 flag:lablock2 0
flagtile @24,22 flag:lablock3 0
flagtile @24,15 flag:lablock4 0
flagtile @20,24 flag:lablock5 0
flagtile @22,24 flag:lablock6 0
flagtile @24,26 flag:lablock7 0
toggle @28,8 flag:lablock1 0
toggle @19,5 flag:lablock2 0
toggle @6,14 flag:lablock3 0
toggle @19,13 flag:lablock4 0
toggle @5,31 flag:lablock5 0
toggle @17,31 flag:lablock6 0
toggle @29,31 flag:lablock7 0
