21212121212121212121212121212121212121212121212121212121212121212121212121212121
21212121212121212121212121212121212121212121212121212121212121212121212121212121
21211331310304313114133131313131313131313131313131313131313131311421212121212121
21212200000000000020220000000000000000000000000000000000000000002021212121212121
21212200000000000020220000001011111111111111111200000000000000002021212121212121
21212200000000330020220000002013313103043131142200000000000000002021212121212121
21212200000033000020220000002022000000000000202200003300330000002021212121212121
21212200003300000020220000002022000000330000202200000000000000002021212121212121
21212200330000000030320000003032000000000000202200330033003300002021212121212121
21212200000000000000000000000000003300003300202200000000000000002021212121212121
21212200000000000010120000001012000000000000202200003300330000002013313131142121
21212200000000000020220000002022000000000000202200000000000000003032000000202121
21212200000000000020220000002023111111111111242200330033003300000000000000202121
21212311111111111124220000002013313103043131142200000000000000001012000000202121
21211331310304313114220000002022000000000000202200003300330000002023111111242121
21212200000000000020220000002022003300003300202200000000000000002021212121212121
21212200000000000030320000003032000000000000202200000000000000002021212121212121
21212200330000000000000000000000000000000000202200333310111111112421212121212121
21212200003300000010120000001012000000000000202201000120212121212121212121212121
21212200000033000020220000002022000000000000202233330020212121212121212121212121
21212200000000330020220000002022003300003300202201000120133131311413313431142121
21212200000000000020220000002022000000000000202200333330320000002022000000202121
21212311111111111124220000002023111111111111242201000100010000002022000000202121
21211331313131313131320000003031313131313131142311111111120000003032000000202121
21212200000000000000000000000000000000000000202121212121231112000100000000202121
21212200101111111111120000001011111111111111242121212121212123111112000000202121
21212200201303043114220000002013313103043131141331310304313131311422000000202121
21212200202200000020220000002022000000000000202200000000000000002022000000202121
21212200202200000030320000003032000010120000202200000000000000002022000000202121
21212200202200330000000000000000000030320000202200003300003300003032000000202121
21212200202200000010120000001012000000000000202200000000000000000000000000202121
21212200202200000020220000002022000000000000202200000000000000001012000000202121
21212200202311111124220000002023111111111111242311111111111111112422000000202121
21212200303131313131320000003031313131313131313131313131313131313132000000202121
21212200000000000000000000000000000000000000000000000000000000000000000000202121
21212200000000000000000000000000000000000000000000000000000000000000000000202121
21212200000000000000000000000000000000000000000000000000000000000000000000202121
21212311111111111111111111111111111111111111111111111111111111111111111111242121
21212121212121212121212121212121212121212121212121212121212121212121212121212121
21212121212121212121212121212121212121212121212121212121212121212121212121212121

image image:lab
song song:scholar
battlebg (u16)1
door @35,20 map:library @3,12 0x0000
sprite sprite:scholar @30,22 flag:book2 0x000000
flagtile @32,24 flag:book2 0
sprite sprite:kitchen @35,12 0x80201004
battle battle:coyote 0x0001
battle battle:skeleton 0x0003
battle battle:eyeball 0x0003
flagtile @24,18 flag:lablock1 0
flagtile @26,18 flag:lablock2 0
flagtile @24,20 flag:lablock3 0
flagtile @26,20 flag:lablock4 0
flagtile @24,22 flag:lablock5 0
flagtile @26,22 flag:lablock6 0
flagtile @28,22 flag:lablock7 0
toggle @6,2 flag:lablock1 0
toggle @19,5 flag:lablock2 0
toggle @6,14 flag:lablock3 0
toggle @19,13 flag:lablock4 0
toggle @7,26 flag:lablock5 0
toggle @19,26 flag:lablock6 0
toggle @27,26 flag:lablock7 0
