00000000000000000000000000000000000000000000000000000000000000000000000000000000
00000000000000000000000000000000000000000000000000000000000000000000000000000000
00000000000000000000000000000000000000000000000000000000000000000000000000000000
00000000000000000000000000000000000000000000000000000000000000000000000000000000
00000000000000000000000000000000000000000000000000000000000000000000000000000000
00000000000000000000000000000000000000000000000000000000000000000000000000000000
00000000000000000000000000000000000000000000000000000000000000000000000000000000
00000000000000000000000000000000000000000000000000000000000000000000000000000000
00000000000000000000000000000000000000000000000025151515252515151525251515000000
00000000000000000000000000000000000000000015152515000000000000000000000025150000
00000000000000000000000000000000000025251515000000000000000000000000000000152500
00000000000000000000000000000000000015000000000000000000000000000000000000001500
00000000000000000000000000000000002500000000000000000000000000000000000000000010
00000000000000000000000000000000150025251500000000000015000000000000000000000020
00000000000000000000000000001515000000150000000000000025000000000000000000000020
00000000000000000000000000002500000000250015252500252525002515250000000000000020
00000000000000000000000000252500000000150015002500250025002500150000000000000020
00000000000000000000000000150000000000250015251500152525001525150000000000000020
00000000000000000000000000250000000000000000000000000000000000000000000000000020
00000000000000000000000000250000002500000000002500000000000000000000000000000020
00000000000000000000000000250000002500152515002500000000000000000000000500000020
00000000000000000000000000250000002500000025001500000000000000000000000000000020
00000000000000000000000000151500001500101112001012000000000000000000000000000020
00000000000000000000000000001500002515303132003032000000000000000000000000000020
00000000000000000000000000000025000000000000000000000000000000000000000000000020
00000000000000000000000000000025000000000000000000000000000000000000000000000020
00000000000000000000000000000000250000000000000000000000000000000000000000000020
00000000000000000000000000000000252500000000000000000000000000000000000000000020
00000000000000000000000000000000002515000000000000000000000000000000000000000020
00000000000000000000000000000000000015150000000000000000000000000000000000000020
00000000000000000000000000000000000000001525000000000000000000000000000000000030
00000000000000000000000000000000000000000015150000000000000000000000000015152500
00000000000000000000000000000000000000000000151525000000000025152525152500000000
00000000000000000000000000000000000000000000000000251525151500000000000000000000
00000000000000000000000000000000000000000000000000000000000000000000000000000000
00000000000000000000000000000000000000000000000000000000000000000000000000000000
00000000000000000000000000000000000000000000000000000000000000000000000000000000
00000000000000000000000000000000000000000000000000000000000000000000000000000000
00000000000000000000000000000000000000000000000000000000000000000000000000000000
00000000000000000000000000000000000000000000000000000000000000000000000000000000

image image:library
door @35,20 map:library @3,11 0x0000
sprite sprite:scholar @26,19 flag:book2 0x000000
