21212121212121212121212121212121212121212121212121212121212121212121212121212121
21212121212121212121212121212121212121212121212121212121212121212121212121212121
21212121212121212121212121212121211331352514212121212121212121212121212121212121
21212121212121212121212121212121212200010220212121212121212121212121212121212121
31313131313131313131313131313131313202020230313131313131313131313131313131313131
42010003000200030002010000010102030000060500030203000300030300030101020200010240
52000106010202000102020000000000030101000301000301010001010101000001030003000250
52000303000040414203010002030303060102030102030106020102060301030303030102020150
52010003034054515342010302030303020100010303000302030201010300030102010203020350
52030003035051515152000103030303010101030340414200404142010301000003020203010150
52020002006044514362030100060200010303034054515204505153414202030001060002010250
52010303010160616203000201020303030002405451436201604451515342030200030201010050
52000000010301030201030302010203020040545151520001035051515152000000020100030350
52030301010102010300020602030106000350515151520200015051515152030100000302010350
52010306020300010101000003030003020050515151520002025051515152030300010301020250
52020103010300010602010201004041414154515151534200405451515152000302020103030150
52020000000006030201030301035043616161614451515202505151514362030002030600030350
52000303020101010000030003015052030202006044515200505151436203000001000301020350
52030003060100030240414141415452030203030060616203606161620000010100020002030050
52030203030202010150436161616162020101010203000202020601020203060302000002000150
52020102020302030050520300020001030000000102020203010600020003030200030203030350
53420201030101000050520101010200030200010603010300000603000103020303060202000350
51534141414141414154520300010001010102000102000301000601000102000002030100000050
51436161616161616161620003030001020300010202000203010603020200000106020000000350
43620000020301010200010202010606060606060606060606060603020003010302010000000050
52010203000201010203020001020600020103000202000103020301000201000201030003020150
52000303000300030302020000010603000002000002030100000202000000030003030100000350
52030102020601030106030103000602000303000201010340414141414142010203020002010250
52030202020201020301030002010600000000030102404154515151515153420300020000020050
52030100030102010201020001000600020203404141545151515151515151520303030601030050
52030303010203000203030003010602030003606144515151515151515143620200010101030150
52010202020200060200030101030601000200020360616161444361616162010303010101020050
52030602000002020301030303010603030001010102010201505203000303020102010301000050
52010101010103020303020300030601010203010000020300505201000002030006000201000050
52020200010203020100000202060600030001060101020103505202010103010103010000030350
52000000030003010000000103000101020200020300014041545202030006000203010200020150
53420100000003010600020100030203000103030301005043616200000003000303000201034054
51534201030101000203030300020201020103020302025052020101020203020300034041415451
51515342030202030203030000010001000001020000005052030103010303024041415451515151
51515153414141414141414141414141414141414141415453414141414141415451515151515151

image image:garden
song song:tendrils_underfoot
door @19,2 map:library @18,23 0x0000
sprite sprite:beehive @24,13 flag:book4 0x000000
sprite sprite:kitchen @10,32 0x10080408
flagtile @24,10 flag:book4 0
battle battle:skeleton 0x0800
battle battle:rabbit 0x0400
battle battle:coyote 0x0100
