03030303030303030503030303030303030303030303030503030303
03000000000000000000000000000003000000030000000000000003
03000303030303030303030303030003000300030003030303030003
03000000000000000000000000030000000300000003000000030003
03030303030303030303030300030303030303040303000300030003
03000000000000000000000000030000000300000003000300030003
03000303030303030304030303030003000300030003000300000003
03000000000000000000000000000003000300030003000305030303
03030303030303030303030303030303000300030003000300000003
03000000000000000000000000000003000000030003000300030003
03000303030303030303030403030003030303030003000300030003
03000000000000000000000000030000000000000003000000030003
19191919191919191919191a231819191919191919191a0303030003
29292929291b39393939393a2338393939393939391c2a0000000003
29292929292a131220212030112121322021211132282a0003030303
29292929292a232010202032311211211122102121282a0000000003
29292929292a332111223021122022101231201022282a0304030003
29292929292a133121202220303111311032101112282a0000000003
29292929292a233210151616173215161617201031282a0003050303
1b39393b3c3a332212252626272025262627212121282a0000000003
2a1331301111223021353636371035363637223111282a0303030003
2a23301d181a131212213112213132212030311010282a0000000003
2a33122d282a232122151616173015161617102010282a0003030303
2a13303d282a331222252626272225262627202212282a0000000003
2a23321e282a132222353636371035363637302130282a0303030003
2a33102e383a233221312012213231211230103130282a0000000003
2a1312213010222011303230113030123221212110282a0003030303
2b19191919191919191919191919191919191919192c2a0000000003
393939393939393939393939393939393939393939393a0403030003
03030303030202024041424344450300000000000000000000000003
03030303030202025051525354550300030303030303030303030303
03030303030202026061626364650300000000000000000000000003
03030303030003030303030303030303030303040303030303030003
03030303030000000000000000030000000000000000000000030003
03030303030303030303030300030003030303030303030300030003
03000000000000000000000000030003000000030000000300030003
03000303030303030403030303030003000300000003000000030003
03000000000300000003000000030003000303030303030303030003
03030303000000030000000300000003000000000000000000000003
03030303030303030303030303030303030303030303030303030303

image image:gym
song song:left_hook
battlebg (u16)0
door @3,19 map:library @28,18 0x0000
sprite sprite:gym @12,30 flag:book3 0x000000
battle battle:gauntlet 0x000a
sprite sprite:karate @10,19 0x00000000
sprite sprite:karate @11,19 0x00000000
sprite sprite:karate @15,19 0x00000000
sprite sprite:karate @16,19 0x00000000
sprite sprite:karate @10,23 0x00000000
sprite sprite:karate @11,23 0x00000000
sprite sprite:karate @15,23 0x00000000
sprite sprite:karate @16,23 0x00000000
sprite sprite:sensei @13,16 strings:dialogue (u16)19
