03030303030303030503030303030303030303030303030503030303030303030303030303030303
03000000000000000000000000000003000000030000000000000003000000030000000000000003
03000303030303030303030303030003000300030003030303030003000300030003030303030003
03000000000000000000000000030000000300000003000000030003000300030003000000030003
03030303030303030303030300030303030303030303000300030003000300000003000300030003
03000000000000000000000000030000000300000003000300030003000303040303000300030003
03000303030303030304030303030003000300030003000300000003000000000000000300030003
03000000000000000000000000000003000300030003000303030503030303030303030300030003
03030303030303030303030303030303000300030003000300000000000000000000000000030003
03000000000000000000000000000003000000030003000300030303030303030304030303030003
03000303030303030303030403030003030303030003000300030000000300000000000000000003
03000000000000000000000000030000000000000003000000030003000300030303030303030303
19191919191919191919191a231819191919191919191a0303030003000000030000000300000003
29292929291b39393939393a2338393939393939391c2a0000000003050303030003000300030003
29292929292a131220212030112121322021211132282a0003030303000000000003000000030003
29292929292a232010202032311211211122102121282a0000000000000303030303030303030003
29292929292a332111223021122022101231201022282a0303030303030300000003000000030003
29292929292a131111302220303111311010303132282a0000000000000000030000000300000003
29292929292a231516161616173215161616161711282a0003030303030303030303030303030303
1b39393b3c3a332526262626273025262626262711282a0003000000000000000000000000000003
2a1331301111222526262626273125262626262712282a0003000303030403030303030303030003
2a233030181a133536363636372035363636363732282a0003000000000000000003000000030003
2a331232282a231516161616172115161616161732282a0003030303030303030003000300030003
2a133022282a332526262626273225262626262732282a0003000000000000000003000300030003
2a233220282a132526262626271025262626262720282a0003000303030303030303000300030003
2a331012383a233536363636371235363636363712282a0003000000000000000000000300030003
2a1312213010103032121032103111101212102212282a0003030305030303030303030300030003
2b191919191919191919191a2318191919191919192c2a0000000000000000000000000000030003
39393939393939393939393a233839393939393939393a0303030303030303030303030403030003
03000000000000000000000001000300000000000000000000000000000000000000000000000003
03000000000000000000000000000300030303030303030303030303030303030305030303030303
03000000000000000000000000000300000000000000000000000300000003000000000000000003
03000000030303030303030303030303030303030303040303000300030003000303030303030003
03000000000000000300000003000000030000000300000003000300030003000300000003030003
03000300000003000000030000000300030003000000030000000300030003000000030003000003
03000000030000000300000003000000030003030303030303030300030003030303030003000303
03000300000003000000030000000300030000000000000000000000030000000000000003000003
03000000030000000300000003000000030303030303030303030303030303040303030303030003
03000000000003000000030000000300000000000000000000000000000000000000000000000003
03030303030303030303030303030303030303030303030303030303030303030303030303030303

image image:gym
song song:left_hook
door @3,19 map:library @28,17 0x0000
sprite sprite:rabbit @9,30 flag:book3 0x000000
flagtile @12,29 flag:book3 0
battle battle:skeleton 0x1800
