00000000000000000000000000000000000000000000000000000000000000000000000000000000
00000000000000000000000000000000000000000000000000000000000000000000000000000000
00000000000000000000000000000000000000000000000000000000000000000000000000000000
00000000000000000000000000000000000000000000000000000000000000000000000000000000
00000000000000000000000000000000000000000000000000000000000000000000000000000000
00000000000021212121212100000000000000000000000000000000000000000000000000000000
00000021212100000000002121000000000000000000000000000000000000000000000000000000
00002100000000000000000000212100000000000000000000000000000000000000000000000000
00210000000000000000000000002121000000000000000000000000000000000000000000000000
00210000000000000000000000000000210000000000000000000000000000000000000000000000
21000000000000000000000000000000002121000000000000000000000000000000000000000000
21000000000000000000000000000000000021212100000000000000000000000000000000000000
21002121210000000000000000000000000000002121000000000000000000000000000000000000
21000021000000000021000000000000000000000021210000000000000000000000000000000000
21000021000000000021000000000000000000000000212100000000000000000000000000000000
21000021002121002121002121000000000000000000002100000000000000000000000000000000
21000021002121002121002121000000000000000000000021000000000000000000000000000000
21000000000000000000000000000000000000000000000021000000000000000000000000000000
21000000000000000000000000000000000000000000000021000000000000000000000000000000
21000005000000000000000021210000210021212100000021210000000000000000000000000000
21000000000000000000000021210021210021212100000000210000000000000000000000000000
21000000000000000000000000210000210000000000000000002100000000000000000000000000
21000000000000000000000021210021210000000000000000002100000000000000000000000000
21000000000000000000000000000000000000000000000000002100000000000000000000000000
21210000000000000000000000000000000000000000000000002100000000000000000000000000
00210000000000000000000000000000000000000000000000002100000000000000000000000000
00210000000000000000000000000000000000000000000000002100000000000000000000000000
00212100000000000000000000000000000000000000000000002100000000000000000000000000
00002121210000000000000000000000000000000000000000002100000000000000000000000000
00000000212100000000000000000000000000000000000021210000000000000000000000000000
00000000002121210000000000000000000000000000002121000000000000000000000000000000
00000000000000002121212121212121212121212121212100000000000000000000000000000000
00000000000000000000000000000000000000000000000000000000000000000000000000000000
00000000000000000000000000000000000000000000000000000000000000000000000000000000
00000000000000000000000000000000000000000000000000000000000000000000000000000000
00000000000000000000000000000000000000000000000000000000000000000000000000000000
00000000000000000000000000000000000000000000000000000000000000000000000000000000
00000000000000000000000000000000000000000000000000000000000000000000000000000000
00000000000000000000000000000000000000000000000000000000000000000000000000000000
00000000000000000000000000000000000000000000000000000000000000000000000000000000

image image:library
door @3,19 map:library @28,17 0x0000
sprite sprite:rabbit @10,18 flag:book3 0x000000
