a1a1a1a1a1a1a1a1a1a1a1a1a1a1a1a1a1a1a1a1a1a1a1a1a1a1a1a1a1a1a1a1a1a1a1a1a1a1a1a1a1a1a1a1
a1a1a1a1a1a1a1a1a1a1a1a1a1a1a1a1a1a193b1b1b1b194a193b1b1b194a1a1a1a1a1a1a1a1a1a1a1a1a1a1
a1a1a1a193b1b1b1b1b1b1b1b1b1b194a1a1a284828481b0b1b2808184a0a1a1a1a1a1a1a1a1a193b1b1b194
a1a1a1a1a286878680878381868784b094a1a282888380838281878883a0a1a1a1a1a1a1a1a1a1a2868281a0
a1a1a1a1a28290919191919192878187a0a1a391919192869092838585a0a1a1a1a1a1a1a1a1a1a2808884a0
a1a1a1a1a281a0a1a1a1a1a1a2868882a093b1b194a1a284a0a3919191a4a1a1a1a1a1a1a1a1a1a2808784a0
a193b1b1b283a0a1a1a1a1a1a2868281a0a28882a0a1a391a4a1a1a193b1b1b194a1a1a1a1a1a1a2869091a4
a1a280818086a0a1a1a1a1a1a3919191a4a28187a0a1a1a1a1a1a1a1a2808385a0a1a1a1a1a1a1a286a0a1a1
a1a282909191a4a1a1a1a1a1a1a1a1a1a1a28590a4a1a1a1a193b1b1b2858885a0a1a1a1a1a1a1a284a0a1a1
a1a282a0a1a193b1b1b194a1a1a1a1a1a1a287a0a1a1a1a1a1a2858080848581a0a1a1a1a1a1a1a287a0a1a1
93b281a0a1a1a2858587b0b1b1b1b1b1b1b280a0a1a1a1a1a1a2849091919191a4a193b1b1b1b1b282a0a1a1
a28782a0a1a1a2808884818687838580848081a0a1a1a1a1a1a280a0a1a1a1a1a1a1a2888680838085a0a1a1
a28190a4a1a1a2868687909192809091919286a0a1a1a193b1b281a0a1a1a1a1a1a1a2878090919191a4a1a1
a282a0a1a1a1a3919191a4a1a282a0a1a1a281b094a1a1a2838282a0a1a1a1a1a1a1a39285a0a1a1a1a1a1a1
a281a0a1a1a1a1a1a1a1a1a1a281a0a1a1a28286a0a1a1a2858887a0a1a1a1a1a1a1a1a280a0a1a1a1a1a1a1
a281a0a1a1a1a1a1a1a1a1a1a286a0a1a1a39282a0a1a1a2818381b0b1b1b1b1b1b1b1b280a0a1a1a1a1a1a1
a287a0a1a1a1a1a1a1a1a1a1a281a0a1a1a1a285a0a1a1a392818483838184838385838685a0a1a1a1a1a1a1
a283b0b194a1a193b1b1b1b1b281a0a1a1a1a282a0a1a1a1a3919191919191919191919191a4a1a1a1a1a1a1
a2848687a0a1a1a2848785818186a0a1a1a1a287a0a1a1a1a1a1a1a1a1a1a1a1a1a1a1a1a1a1a1a1a1a1a1a1
a3919280a0a1a1a2868884909191a493b1b1b281a0a1a1a1a1a1a1a1a1a1a1a1a193b1b1b194a1a1a1a1a1a1
a1a1a284a0a1a1a2808682a0a1a1a1a287838182a0a1a1a1a1a1a1a1a1a1a1a1a1a2868082a093b1b194a1a1
a1a1a285a0a1a1a3919191a4a1a1a1a287888090a4a1a1a1a1a1a1a1a1a1a1a1a1a2878880a0a28785a0a1a1
a1a1a287a0a1a1a1a1a1a1a1a1a1a1a2808482a0a1a1a1a1a1a1a1a1a1a1a1a1a1a2828584a0a28887a0a1a1
a1a1a281b0b194a1a1a1a1a1a1a1a1a3919191a4a1a1a1a1a1a1a1a1a1a1a1a1a1a3919191a4a39281a0a1a1
a1a1a2878284a0a1a1a1a1a1a1a193b1b194a1a1a1a1a193b1b1b1b1b194a1a1a1a1a1a1a1a1a1a282a0a1a1
a1a1a2808880a0a1a1a1a1a1a1a1a28883a0a1a1a1a1a1a28585858084a0a1a1a1a1a193b1b1b1b287a0a1a1
a1a1a2868485a0a1a1a1a1a1a1a1a28180a0a1a1a1a1a1a28190919281b0b1b1b1b1b1b28380838180a0a1a1
a1a1a3919191a4a1a1a1a1a1a1a1a39287a0a1a1a1a1a1a281a0a1a286858084878481808690919191a4a1a1
a1a1a1a1a1a1a1a1a1a1a1a1a1a1a1a284a0a1a1a1a1a1a281a0a1a3919191928590919191a4a1a1a1a1a1a1
a1a1a1a1a1a1a1a1a1a1a1a1a1a1a1a287a0a1a1a1a1a1a287a0a1a1a1a1a1a283a0a1a1a1a1a1a1a1a1a1a1
a1a1a1a1a1a1a1a1a1a1a1a1a1a1a1a281a0a1a1a1a1a1a281a0a1a1a1a1a1a282a0a1a1a1a1a1a1a1a1a1a1
a1a1a1a1a1a1a1a1a1a1a1a1a1a1a1a287a0a1a1a1a1a1a284a0a1a1a1a1a1a286a0a1a1a1a1a1a1a1a1a1a1
a1a1a1a1a1a1a1a1a1a1a1a1a1a1a1a285a0a1a1a1a1a1a285a0a1a1a1a1a1a281a0a1a1a1a1a1a1a1a1a1a1
a1a1a1a1a1a1a1a1a1a1a1a1a1a1a1a282b0b1b1b1b1b1b286a0a1a1a1a1a1a287a0a1a1a1a1a1a1a1a1a1a1
a1a1a1a1a1a1a1a1a1a1a1a1a1a1a1a2878186858783838385a0a1a1a1a1a1a391a4a1a1a1a1a1a1a1a1a1a1
a1a1a1a1a1a1a1a1a1a1a1a1a1a1a1a3919191919191919191a4a1a1a1a1a1a1a1a1a1a1a1a1a1a1a1a1a1a1
a1a1a1a1a1a1a1a1a1a1a1a1a1a1a1a1a1a1a1a1a1a1a1a1a1a1a1a1a1a1a1a1a1a1a1a1a1a1a1a1a1a1a1a1
a1a1a1a1a1a1a1a1a1a1a1a1a1a1a1a1a1a1a1a1a1a1a1a1a1a1a1a1a1a1a1a1a1a1a1a1a1a1a1a1a1a1a1a1
a1a1a1a1a1a1a1a1a1a1a1a1a1a1a1a1a1a1a1a1a1a1a1a1a1a1a1a1a1a1a1a1a1a1a1a1a1a1a1a1a1a1a1a1
a1a1a1a1a1a1a1a1a1a1a1a1a1a1a1a1a1a1a1a1a1a1a1a1a1a1a1a1a1a1a1a1a1a1a1a1a1a1a1a1a1a1a1a1

image image:cemetery
song song:worms_lair
battlebg (u16)6
battle battle:skeleton 0x0007
battle battle:eyeball 0x0006
battle battle:eviltwin 0x0004
door @35,11 map:cemetery @35,11 0 0
door @8,11 map:cemetery @8,11 0 0
door @14,5 map:cemetery @14,5 0 0
door @18,6 map:cemetery @18,6 0 0
door @20,3 map:cemetery @20,3 0 0
door @27,3 map:cemetery @27,3 0 0
door @41,4 map:cemetery @41,4 0 0
door @30,8 map:cemetery @30,8 0 0
door @25,14 map:cemetery @25,14 0 0
door @9,19 map:cemetery @9,19 0 0
door @17,21 map:cemetery @17,21 0 0
door @4,25 map:cemetery @4,25 0 0
door @15,25 map:cemetery @15,25 0 0
door @35,21 map:cemetery @35,21 0 0
door @39,22 map:cemetery @39,22 0 0
sprite @23,5 sprite:kitchen 0x21004020
