00000000000000000000000000000000000000000000000000000000000000000000
00000000000000000000000000000000000000000000000000000000000000000000
00000000000000000000000000000000000000000000000000000000000000000000
00000000000000000000000000000000000000000000000000000000000000000000
00000000000000000000000000000000000000000000000000000000000000000000
00000000001331313114212121211331150025313131313131313131140000000000
00000000002200000030313131313200000000000000000000000000200000000000
00000000002200000000000000000000000000000000000000000000200000000000
00000000002200000010111200000000000000000010120000000000200000000000
00000000002312001024212312000000000000101124231112000000200000000000
00000000002122003031313132000000000010242121212122000000250000000000
00000000002122000000000000000000000020212121212122000000000000000000
00000000002122000000000000000000000020212121212122000000150000000000
00000000002123120000101200000000000030142121212122000000200000000000
00000000001331320000303312000000000000303114133132000000200000000000
00000000001500000000003033120000000000000020220000000000200000000000
00000000000000000000000030331200000000000020220400000000200000000000
00000000002500000000000000303200000000000020231111111111240000000000
00000000002200000000000000000000000000000030313131313131140000000000
00000000002200000000000000000000000000000000000000000000200000000000
00000000002311111111111111111200000000000000000000000000200000000000
00000000002121212121212121212200000000000000000000000000200000000000
00000000002121212121212121212311111125001511111111111111240000000000
00000000000000000000000000000000000000000000000000000000000000000000
00000000000000000000000000000000000000000000000000000000000000000000
00000000000000000000000000000000000000000000000000000000000000000000
00000000000000000000000000000000000000000000000000000000000000000000
00000000000000000000000000000000000000000000000000000000000000000000

image image:library
hero @25,15
door @23,16 map:3 @15,8 0 0
