21212121212121212121212121212121212121212121212121212121212121212121
21212121212121212121212121212121212121212121212121212121212121212121
21212121211331310c050b3131313131313114212121212121212121212121212121
21212121212200000000000000000000000020212121212121212121212121212121
212121212122004446454745670066464748202121130c0931080c14212121212121
21212121212200545557565677007655557520212122000400030020212121212121
21212121212200000000000000000000000020212122000000000020212121212121
21212121212244454748006447454747480020212123120000001024212121212121
21212121212254565577007455555655750030313131320000002021212121212121
21212121212200000000000000000000000000000000000000002021212121212121
21212121212200664645454767004446474746480066454645482021212121212121
21130c05073200745556565558007656565556770076565557582021212121212121
21220000000000000000000000000000000000000000000000002021212121212121
21220066464746456700444547474767006645474547474667002021212121212121
21220074575755557700545656575558005456575555555575002021212121212121
21220000000000000000000000000000000000000000000000002021212121212121
21231111111111111200000010111111111111111244454748002021212121212121
2121212121212121220000002021212121212121227456577500300c050631142121
212121133131313132000000303114131c1d1e142200000000000000000000202121
212121220000000000000000000020222c2d2e202200664746474546476500202121
21212122000000000000000000002022000000303200545656555755577700202121
21212122000000000000000000002022000000000000000000000000000000202121
21212122000000000000010000002023111111111200644645474746474800202121
21212122000000000000000000002021130c050a3200545755575656565800202121
21212122000000000000000000002021220000000000000000000000000000202121
21212123111111111111111111112421220000000000000010111111111111242121
21212121212121212121212121212121231111111111111124212121212121212121
21212121212121212121212121212121212121212121212121212121212121212121

image image:library
hero @8,21
door @25,5 map:3 @15,8 0 0
door @23,5 map:queen @1,1 0x0000
door @9,2 map:cemetery @23,36 0x0000
door @3,11 map:lab @35,20 0x0000
door @18,23 map:garden @20,5 0x0000
door @28,17 map:gym @3,19 0x0000
message @10,22 strings:dialogue (u16)3 1 0
sprite sprite:merchant @17,20 0x0000003e
sprite sprite:customer1 @12,9 strings:dialogue (u16)4
sprite sprite:customer2 @25,24 strings:dialogue (u16)5
sprite sprite:customer3 @23,18 strings:dialogue (u16)6
