133131313131313131353114212121212121212121212121212121212121212121212121212121212121212121212121212121212121212121212121212121212121212121212121212121212121212121212121212121212121212121212121212121212121212121212121212121212121212121212121
220000000000000000000020130214212121212121212121212121212113313131313131313131313131313131313131313131313131313131313131313131313131313131313131313131313131313131313131313131313131313131313131313131313131313131313131313131313114212121212121
220000000000000000000030320030142121212121212121212121212122000000000000000000000000000000000000000000000000000000000000000000000000000000000000000000000000000000000000000000000000000000000000000000000000000000000000000000000020212121212121
220000430043004300430000004300202121212121212121212121212122000000000000000000000000000000000000000000000000000000150000000000002500000000000000000000000000000000000000000000000000000000000000000000000000000000000000000000000020212121212121
220070517151715171517142005300202113313131313131353131313132000000000000000000000000000000000000000000000000000000000000000000000000000000000000000000000000000000000000000000000000000000000000000000000000000000000000000000000020212121212121
220000630063006300530153005300303132000000000000430000000000000000101111111111111111111200101111111112001011111111111111111111111111111111111111111112250015002500150025002500150025001500150000001500150025002500150025002500000020212121212121
220000000000000000507161716171717171717171717171617171717171714200202121212121212121212200202121212122002021212121212121212121212121212121212121212122001500150015001500150015001500150025001500150015002500150025001500250000000020212121212121
220000000000000000530000001011111112000000000000000000000000005300202121212121212121212200202121212122002021212121212121212121212121212121212121212122150015001500150015001500250025001500150000002500150025001500250015001500000020212121212121
220000000000000000530000003031313132001011111111111111111112005300202121212121212121212200303131313132002021212121212121212121212121212121212121212122002500150025002500150015001500150015001500150025001500250025001500150000000020212121212121
220000000000000000530000000000000000002021212121212121212122005300202121212121212121212200000000000000002021212121212121212121212121212121212121212122250015002500250015001500250015001500150000002500150015002500150025002500000020212121212121
231111111111111200530010111111111111112421212121212121212122005300202121212121212121212311111111111111112421212121212121212121212121212121212121212122001500150015001500250015002500150015001500150025002500150015002500150000000020212121212121
212121212121212200530020212121212121212121212121212121212122005300202121212121212121212121212121212121212121212121212121212121212121212121212121212122250025001500150015001500250015002500000000000000000025001500150015002500000020212121212121
212121212121212200530020212121212121212121212121212121212122005300202121212121212121212121212121212121212121133131313114212121212121212121212121212122001500150015001500250015001500150000000000000000002500150025001500150000000020212121212121
212121212121212200530020212121212121212121212121212121212122005300202121212121212121212121212121212121212121220000000020212121212121212121212121212122250015001500250015001500250025001500000000000000000015001500150015001500000020212121212121
212121212121212200530020212121212121212121212113313131313132005300202121212121212121212121212121212121212121220010120020212121212121212121212121212122001500150015002500150015001500150025001500250015001500250015001500250000000020212121212121
212121212121212200530020212121212121212121212122000000000000005300202121212121211331313131313131313131313131320030320030313131313131313131313131313132150025001500150025001500250015001500150015001500150025002500150025002500000020212121212121
212121212121212200530020212121212121212121212122004071717171715200202121212121212200000000000000000000000000000000000000000000000000000000000000000000000000000000000000000000000000000000000000000000000000000000000000000000000020212121212121
212113313131313200530030313131142121212121212122005300000000005300202121212121212200000000000000000000000000000000000000000000000000000000000000000000000000000000000000000000000000000000000000000000000000000000000000000000000020212121212121
212122000000000000630000000000202121212121212122005300000000005300202121212121212200000000000000000000000000000000000000000000000000000000000000000000000000000000000000000000000000000000000000000000000000000000000000000000000020212121212121
212122000000000000000000000000303131313114212122005300000000005300202121212121212200000010111111111111111111111111111111111111111111111111111112000000101111111111111111111111111112000000101111111111111111111111111111111200000020212121212121
212122000000000000000000000000000000000020212122005071717171716200202121212121212200000020212121212121212121212121212121212121212121212121212122000000202121212121212121212121212123111111242121212121212121212121212121212200000020212121212121
212122000000000000000000000000000000000020212122005300000000000000202121212121212200000020212121212121212121212121212121212121212121212121212122000000202121212121212121212121212121212121212121212121212121212121212121212200000020212121212121
212122000000000000000000000000101200000020212122005300101111111111242121212121212200000020212121212121212121212121212121212121212121212121212122000000301421212121212121212121212121212121212121212121212121212121212121212200000020212121212121
212122000000000000000000000000202200000020212122005300202121212121212121212121212200000020212121212121212121212121212121212121212121212121212122000000002021212121212121212121212121212121212121212121212121212121212121212200000020212121212121
212122000000000000000000000000202200000020212122005300202121212121212121212121212200000020212121212121211331142121212121212121212121212121212122000000102421212121212121212121212121212121212121212121212121212121133131313200000020212121212121
212123111111111111111111111111242200000020212122005300202121133131313131313131313200000030313131313131313200303131313131313131313131313114212122000000202121212121212121212121212121212121212121212121212121212121220000000000000020212121212121
212121212121212121212121212121212200000020212122005300202121220000000000000000000000000000000000000000000000000000000000000000000000000020212122000000202121212121212121212121212121212121212121212121212121212121220010111200000020212121212121
212121212121212121212121212121212200000020212122005300202121220000000000000000000000000000000000000000000000000000000000000000000000000020212122000000202121212121212121212121212121212121212121212121212121212121220020212200000020212121212121
212121212121212121212121212121212200000020212122005300202121220000101111111111111111111111111111111111111111111111120010111111111112000020212122000000202121212121212121212121212121212121212121212121212121212121220030313200000020212121212121
212121212121212121212121212121212200000020212122005300202121220000202121212121212121212121212121212121212121212121231124212121212122000020212122000000301421212121212121212121212121212121212121212121212121212121220000000000000020212121212121
212121212121212121212121212121212200000020212122005300202121220000202121212121212113311421212121212121212121212121212121212121212122000020212122000000002021212121212121212121212121212121212121212121212121212121231111111200000020212121212121
212121212121212121212121212121212200000020212122005300202121220000202121133131313132003031313131313131313131313131313131313114212122000020212122000000002021212121212121212121212121212121212121212121212121212121212121212200000020212121212121
212121212121212121212113313131313200000030311422005300202121220000202121220000000000000000000000000000000000000000000000000020212122000020212122000000102421212121212121212121212121212121212121212121212121212121212121212200000020212121212121
212121212121212121212122000000000000000000002022005300202121220000202121220010111111111111111111111111111111111111111111120020212122000020212122000000202121212121212121212121212121212121212121212121212121212121212121212200000020212121212121
212121212121212121212122001011111111111112002022005300301421220000202121220020212121212121212121212121212121212121212121220020212122000020212122000000202121212121212121212121212121212121212121212121212121212121212121212200000020212121212121
212121212121212121212122002021212121212122002022005300002021220000202121220020212121212121212121212121212121212121212121220020212122000020212122000000303131313131313131313131313131313131313131313131313131313131313131313200000030313131313114
212121212121212121212122002021212121212122002022005300102421220000202121220020212113313131313131313131313131313131142121220020212122000020212122000000000000000000000000000000000000000000000000000000000000000000000000000000000000000000000020
212121212121212121212122002021212121212122002022005300202121220000202121220020212122000000000000000000000000000000202121220020212122000020212122000000000000000000000000000000000000000000000000000000000000000000000000000000000000000000000020
212121212121212121212122003031313131313132002022005300202121220000202121220020212122001011111111111111111112001500202121220020212122000020212122000000000000000000000000000000000000000000000000000000000000000000000000000000000000000000000020
212121212121212121212122000000000000000000002022005300202121220000202121220020212122002021212121212121212122000000202121220020212122000020212122000000101111111111111111111112000010111111111111111111111112001011111200101111111111111200000020
212121212121212121212123111200001011111111112422005300202121220000202121220020212122002021212121212121212123111111242121220020212122000020212122000000202121212121212121212123111124212121212121212121212122002021212311242121212121212200000020
212121212121212121212121212200002021212121212122005300202121220000202121220020212122002021212121212121212121212121212121220020212122000020212122000000202121212121212121212121212121212121212121212121212122002021212121212121212121212200000020
212121212121212121212121212200002021212121212122005300202121220000202121220020212122002021211331142121212121212121212121220020212122000020212122000000202121212121212121212121212121212121212121212121212122002021212121212121212121212200000020
212121212121212121212121212200002021212121212122005300202121220000202121220020212122003031313200303131313131313131313131320020212122000020212122000000202121212121212121212121212121212121212121212121212122002021212121212121212121212200000020
212121212121212121212121212200002021212121211332005300202121220000202121220020212122000000000000000000000000000000000000000020212122000020212122000000202121212121212121212121212121212121212121212121212122002021212121212121212121212200000020
212121212121212121212121212200002021212121212200005300202121220000202121220020212123111111111111111111111111111111111111111124212122000020212122000000202121212121212121212121212121212121212121212121212122002021212121212121212121212200000020
212121212121212121212121212200002021212121212312005300202121220000202121220020212121212121212121212121212121212121212121212121212122000020212122000000202121212121212121212121212121212121212121212121212122002021212121212121212121212200000020
211331313131313131313131313200002021212121212122005300202121220000202121220020212121212121212121212121212113311421212121212121212122000020211332000000303131313114212121212121212121212121212121212121212122003031313131313131313131313200000020
212200000000000000000000000000002021212121212122005300202113320000202121220030313131313131313131313131313132003031313131313131313132000020212200000000000000000020212121212121212121212121212121212121212122000000000000000000000000000000000020
212200000000000000000000000000002021212121212122005300202122000000202121220000000000000000000000000000000000000000000000000000000000000020212312000000101111120020212121212121212121212121212121212121212123111111111111111111111111111200000020
212200001011111111111111111111112421212121212122005300202123120000202121220010111111111111111111111111111112001011111111111111111112000020212122000000202121220020212121212121212121212121212121212121212121212121212121212121212121212200000020
212200003031313131313131311421212121212121212122005300202121220000202121220020212121212121212121212121212123112421212121212121212122000020212122000000202121220020212121212121212121212121212121212121212121212121212121212121212121212200000020
212200000000000000000000002021212121212121212122005300202121220000202121220020212121212121212121212121212121212121212121212121212122000020212122000000303131320020212121212121212121212121212121212121212121212121212121212121212121212200000020
212200000000000000000000002021212121212121212122005300202121220000202121220020211331313131313131313131313131313131313131313114212122000020212122000000000000000020212121212121212121212121212121212121212121212121212121212121212121212200000020
212200000015001500250000002021212121212121212122005300202121220000202121220020212200000000000000000000000000000000000000000020212122000020212122000000101111111124212121212121212121212121212121212121212121212121212121212121212121133200000020
212200000000000000000000002021212121212121212122005300202121220000301421220020212200101111111111111111111111111111111111120020212122000020212122000000202121212121212121212121212121212121212121212121212121212121212121212121212121220000000020
212200000015001500250000003031313131313131313132005300202121220000002021220020212200201331313131313131313131313131313114220020212122000020212122000000202121212121212121212121212121212121212121212121212121212121212121212121212121231200000020
212200000000000000000000000000000000000000000000005300202121220000102421220020212200202200000000000000000000000000000020220020212122000020212122000000202121212121212121212121212121212121212121212121212121212121212121212121212121212200000020
212200000015002500150000000000000000101200000000005300202121220000202121220020212200202200101111111111111111111111120020220020212122000020212122000000303131313131313131313131313131313131313131313131313131313131313131313131313131313200000020
212200000000000000000000001012000000303200001012005300202121220000202121220020212200202200202121212121211331313114220020220020212122000030142122000000000000000000000000000000000000000000000000000000000000000000000000000000000000000000000020
212200000000000000000000002022000000000000002022005300202121220000202121220020212200202200202121212121212200000020220020220020212122000000202122000000000000000000000000000000000000000000000000000000000000000000000000000000000000000000000020
212311111111111111111111112422000010111111112422005300202121220000202121220030313200202200303131313131313200150020220020220020212122000010242122000000000000000000000000000000000000000000000000000000000000000000000000000000000000000000000020
212121212121212121211331313132000020212121212122005300202121220000202121220000000000202200000000000000000000000020220020220020212122000020212122000000101111111111111111111111111111111111111112000010111111111111111111111111111111111111111124
212121212121212121212200000000000020212121212122005300202121220000202121220010111111242311111111111111111111111124220020220020212122000020212122000000202121133131313131313131313131313131311422000020133131313131313131313131313131311421212121
212121212121212121212240720000000020212121212122005300202121220000202121220020211331313131313131313131313131313131320020220020212122000020212122000000202121220000000000000000000000000000002022000020220000000000000000000000000000002021212121
211331313131313114212253001011111124212121212122005300202121220000202121220020212200000000000000000000000000000000000020220020212122000020212122000000202121220000000000000000000000000000002022000020220000250000000000000000000025002021212121
212200000000000020212253002021212121212121212122005300202121220000202121220020212200101111111111111111111111111111111124220020212122000020212122000000202121220000101112000000101112000000002022000030320000000000000000000000000000002021212121
212200000000150030313253002021212121212121212122005300202121220000202121220020212200303131313131313131313131313131313131320020212122000020212122000000301421220000201332000000301422000000002022000000000000150000000000000000000015002021212121
212200000000000000000053002021133131313131311422005300202121220000301421220020212200000000000000000000000000000000000000000020212122000020212122000000002021220000202200000000002022000000002022000010120000000000000000000000000000002021212121
212200000000000010111253002021220000000000002022005300202121220000002021220020212311111111111111111111111111111111111111111124212122000020212122000000102421220000303200101112003032000000002022000020220000150000000000000000000025002021212121
212200000000000020212253002021220000000000002022005300202121220000102421220020212121212121212121212121212121212121212121212121212122000020211332000000202121220000000000202122000000000000003032000020220000000000000000000000000000002021212121
212311111111111124212253003031320000101200002022005300202121220000202121220020212121212121212121212121212121211331142121212121212122000020212200000000202121220000000000202123111112000000000000000020231111111111111111111111111111112421212121
211331313131313114212253000000000000303200002022005300202121220000202121220030313131313131313131313131313131313200303131313131313132000020212312000000202121220000000000303131313132000000001012000020133131313131313131313131313131311421212121
212200000000000020212253001011120000000000002022005300301421220000202121220000000000000000000000000000000000000000000000000000000000000020212122000000202121220000000000000000000000000000002022000020220000000000000000000000000000002021212121
212200000000000030313253002021220000000000002022005300002021220000202121220000000000000000000000000000000000000000000000000000000000000020212122000000202121220000000000000000000000000000002022000020220000001012000000000000101200002021212121
212200000000000000000053002021231111111111112422005300102421220000202121231111111111111111111111111111111111111111111111111111111111111124212122000000202121231111111111111111111111111111112422000030320000003032000010120000303200002021212121
212200001500000010111253002021212121212121212122005300202121220000202121212121212121212121212121212121212121212121212121212121212121212121212122000000202121133131313131313131313131313131311422000000000000000000000020220000000000002021212121
212200000000000020212253002021133131313131311422005300202121220000202121212121212121212121212121133114212121212121212121212121212121212121212122000000202121220000000000000000000000000000002022000010120000001012000030320000101200002021212121
212311111111111124212253003031320000000000002022005300202121220000303131313131313131313131313131320030313131313131313131313131313131313131313132000000202121220000000000000000000000000000002022000020220000003032000000000000303200002021212121
211331313131313114212253000000000000000000002022005300202121220000000000000000000000000000000000000000000000000000000000000000000000000000000000000000202121220000000000101111111200000000003032000020220000000000000000000000000000002021212121
212200000000000020212253001011120000101200002022005300202121220000000000000000000000000000000000000000000000000000000000000000000000000000000000000000202121220000000000202121212200000000000000000020231111111111111111111111111111112421212121
212200000000000030313253002021220000303200002022005300202121220000000000000000000000000000000000000000000000000000000000000000000000000000000000000000202121220000000000303131313200000000001012000020133131313131313131313131313131311421212121
212200000015000000000053002021220000000000002022005300202121231111111111111111111111111111111111111111111111111111120010111111111112001011111111111111242121220000000000000000000000000000002022430020220000000000000000000000000000002021212121
212200000000000010111253002021220000000000002022005300202121212121212121212121212121212121212121212121212121212121231124212121212122003031313131313131142121220000000000000000000000000000002022530020220000000000000000000000000000002021212121
212200000000000020212253002021231111111111112422005300202121212113311421212121212121212121211331142121212121212121212121212121212122000000000000000000202121231112001011111111111111111111112422530030320000000000000000000000000000002021212121
212311111111111124212253002021212121212121212122005300303131313132003031313131313131313131313200303131313131313131313131313131142123111111111111111200202121133132003031313131141331313131311422530000000000000025000015000015000000002021212121
212113313131313131313253002021212121212121212122005300000000000000000000000000000000000000000000000000000000000000000000000000202121212121212121212200202121220000000000000000202200000000002022530010120000000000000000000000000000002021212121
212122000040717171717162002021212121212121212122006071717171717171717171717171717171717171717171717171717171717171717171714200303131313131313131313200202121220000000000000000202200000000002022530020220000000000000000000000000000002021212121
212122000053000000000000002021212121212121212122000000000000000000000000000000000000000000000000000000000000000000000000005300000000000000000000000000202121220000000000000000202200000100003032530020220000000000000000000000000000002021212121
212122000053001011111111112421212121212121212123111111111111111111111111111112001011111111111111111111111200101111111112005300101112001011111111111111242121220000000000000000202200007071717171520020231111111111111111111111111111112421212121
212122000053002021212121212121212121212121212121212121212121212121212121212123112421212121212121212121212311242121212122005300202122002021212121212121212121220000000000000000202200000000001012530020133131313131313131313131313131311421212121
212122000053002021212121212121212121212121212121212121212121212121212121212121212121212121212121212121212121212121212122005300202122002021212121212121212121220000000000000000202200000000002022530020220000000000000000000000000000002021212121
212122000053002021212121212121212121212121212121212121212121212121212121212121212121212121212121212121212121212121212122005300202122002021212121212121212121220000000000000000202311111111112422530020220000000000000000000000000000002021212121
212122000053002021212121212121212121212121212121212121212121212121212121212121212121212121212121212121212121212121212122005300202122002021212121212121212121231111111111111111242121212121212122530030320000001012000000001012000000002021212121
212123120053002021212121212121212121212121212121212121212121212121212121212121212121212121212121212121212121212121212122005300202122002021212121212121212121212121212121212121212121212121212122530000000000002022000000002022000000002021212121
212121220053002021212121212121212121212121212121212121212121212121212121212121212121212121212121212121212121212121212122005300202122002021212121212121212121212121212121212121212121212121212122630010120000003032000000003032000000002021212121
212121220053002021212121212121212121212121212121212121212121212121212121212121212121212121212121212121212121212121212122005300202122002021212121212121133114212121212121212121212121212121212122000020220000000000000000000000000000002021212121
212121220053002021212121212121212121212121212113313131313131313131313131313131313131313131313131313131313131313114212122005300202122003031313131313131320030313131313131313131313131313131313132000020220000000000000000000000000000002021212121
212121220053002021212121212121212121212121212122000000000000000000000000000000000000000000000000000000000000000020212122005300202122000000000000000000000000000000000000000000000000000000000000000020231111111111111111111111111111112421212121
212121220053002021212121212121212121212121212122000015000015000015000025000015000015000025000015000015000015000020212122005300202123111111111111111111111111111111111111111111111111111111111112000020212121212121212121212121212121212121212121
212121220053002021212121212121212121212121212122000000000000000000000000000000000000000000000000000000000000000020212122005300202121212121212121212121212121212121212121212121212121212121212122000020212121212121212113311421212121212121212121
212113320053002021212121212121212121212121212122000000000000000000000000000000000000000000000000000000000000000020212122005300202121212121212121211331313131313131313131313131313131142121212122000030313131313131313132003031313131313131142121
212122000053002021212121212121212121212121212122000025000015000025000015000025000025000015000015000025000025000020212122005300202121212121212121212200000000000000000000000000000000202121212122000000000000000000000000000000000000000000202121
212122000053002021212121212121212121212121212122000000000000000000000000000000000000000000000000000000000000000020212122005300301421212121212121212200101200101200101200101200101200202121212122000000000000000000000000000000000000000000202121
212123120053002021212121212121212121212121212122000000000000000000000000000000000000000000000000000000000000000020212122005300002021212121212121212200303200303200303200303200303200202121212123111111111111111112001011111111111111120000202121
212113320053002021212121212121212121212121212122000025000025000025000015000015000015000025000025000015000025000020212122005300102421212121212121212200000000000000000000000000000000202121212121212121212121212123112421212121212121220000202121
212122000053002021212121212121212121212121212122000000000000000000000000000000000000000000000000000000000000000020212122005300202121212121212121212200101200101200101200101200101200202121212121212121212121212121212121212121212121220000202121
212122000053002021211331313131141331313131142122000000000000000000000000000000000000000000000000000000000000000020212122005300202121212121212121212200303200303200303200303200303200202121212121212121212121212121212121212121212121220000202121
212122000053002021212200000000303200000000202122000025000015000015000025000025000015000025000025000015000025000020212122005300202121212121212121212200000000000000000000000000000000202121212121212121212121212121212121212121212121220000202121
212122000053002021212200000000000000000000202122000000000000000000000000000000000000000000000000000000000000000020212122005300202121212121212121212200101200101200101200101200101200202121212121212121212121212121212121212121212121220000202121
212122000053002021212200000000000000000000202122000000000000000000000000000000000000000000000000000000000000000020212122005300202121212121212121212200303200303200303200303200303200202121212121212121212121212121212121212121212121220000202121
212122000053002021212200000000101200000000202122000015000025000015000015000025000015000015000025000025000015000020212122005300202121212121212121212200000000000000000000000000000000202121211331313131313131313131313131313131142121220000202121
212122000053002021212200101111242311111200202122000000000000000000000000000000000000000000000000000000000000000020212122005300202121212121212121212200101111111111111111111111111111242121212200000000000000000000000000000000202121220000202121
212122000053003031313200303131313131313200303132000000000000000000000000000000000000000000000000000000000000000030313132005300303131313131313131313200202121212121212121212121212121212121212200430000000000000000000000000000202121220000202121
212122000053000000000000000000000000000000000000000015000015000015000015000025000025000025000015000015000025000000000000006300000000000000000000000000202121212121212121212121212121212121212200530010111111111111111111120000202121220000202121
212122000053000000000000000000000000000000000000000000000000000000000000000000000000000000000000000000000000000000000000000000000000101111111111111111242121212121211331142121212121212121212200530020212121212121212121220000202121220000202121
212122000060717171717171717171717171717171717171717171717171717171717171717171717171717171717171717171717171717171717172001500150000303131313131313131313131313131313200303131313131313131313200530020212121212121212121220000202121220000202121
212122000000000000000000000000000000000000000000000000000000000000000000000000000000000000000000000000000000000000000000000000000000000000000000000000000000000000000000000000000000000000000000530020212121212121212121220000303131320000202121
212123111111111111111111111111111111111111111111111111111111111111120010111111111111111112001011111111111111111111111112000000007071717171717171717171717171717171717171717171717171717171717171620020212121212121212121220000000000000000202121
212121212121212121212121212121212121212121212121212121212121212121231124212121212121212123112421212121212121212121212122000000000000000000000000000000000000000000000000000000000000000000000000000020212121212121212121220000000000000000202121
212121212121212121212121212121212121212121212121212121212121212121212121212121212121212121212121212121212121212121212123111111111111111111111111111111111111111111111111111111111111111111111111111124212121212121212121231111111111111111242121

image image:library
hero @4,4
battle battle:skeleton 0x1000
battle battle:eyeball 0x0600
battle battle:rabbit 0x0600
message @9,0 strings:dialogue (u16)1 0 0
message @24,4 strings:dialogue (u16)2 0 0
message @10,5 strings:dialogue (u16)3 1 0
message @91,88 strings:dialogue (u16)3 1 0
sprite sprite:sixclops @5,20 0x00000000
sprite sprite:sixclops @3,2 0x00000000
sprite sprite:skeleton @5,2 0x00000000
sprite sprite:eyeball @7,2 0x00000000
sprite sprite:queen @9,2 0x00000000
sprite sprite:moonsong @13,2 0x00000000
sprite sprite:rabbit @3,6 0x00000000
sprite sprite:coyote @5,6 0x00000000
sprite sprite:eviltwin @7,6 0x00000000
