00000000000000000000212121212121212121212100000000000000000000000000000000000000
00000000000021212121210000000000000000000021212121000000000000000000000000000000
00000000212121000000000000000000000000000000000021212100000000000000000000000000
00000000210000000000000000000000000000000000000000002121210000000000000000000000
00000021000000000000000000000000000000000000000000000000212100000000000000000000
00000021000000000000000000000000000000000500000000000000002121000000000000000000
00000021000000000000000000000000000000000000000000000000000000212100000000000000
00000021000000000000000000000000000000000000000000000000000000002121210000000000
00000021000000000000000000000000000000000000000000000000000000000000212100000000
00000021000000002121210000000000000000000000000000000000000000000000002121000000
00000021000000000021000000000021000000000000000000002121000000000000000021000000
00000021210000000021000000000021000000000000000000000021002121000000000000210000
00000000210000000021002121002121002121000000002121002121002100000000000000210000
00000000002100000021002121002121002121000000002121002121002100000000000000210000
00000000002121000000000000000000000000000000000021000000000000000000000000210000
00000000000021210000000000000000000000000000002121000000000000000000000000210000
00000000000000002121000000000000000000000000000000000000000000000000000000210000
00000000000000000021212100000000000000000000000000000000000000000000000000210000
00000000000000000000000021212121000000000000000000000000000000000000002121000000
00000000000000000000000000000000212121210000000000000000000000000000212100000000
00000000000000000000000000000000000000002121212121212121212121212121000000000000
00000000000000000000000000000000000000000000000000000000000000000000000000000000
00000000000000000000000000000000000000000000000000000000000000000000000000000000
00000000000000000000000000000000000000000000000000000000000000000000000000000000
00000000000000000000000000000000000000000000000000000000000000000000000000000000
00000000000000000000000000000000000000000000000000000000000000000000000000000000
00000000000000000000000000000000000000000000000000000000000000000000000000000000
00000000000000000000000000000000000000000000000000000000000000000000000000000000
00000000000000000000000000000000000000000000000000000000000000000000000000000000
00000000000000000000000000000000000000000000000000000000000000000000000000000000
00000000000000000000000000000000000000000000000000000000000000000000000000000000
00000000000000000000000000000000000000000000000000000000000000000000000000000000
00000000000000000000000000000000000000000000000000000000000000000000000000000000
00000000000000000000000000000000000000000000000000000000000000000000000000000000
00000000000000000000000000000000000000000000000000000000000000000000000000000000
00000000000000000000000000000000000000000000000000000000000000000000000000000000
00000000000000000000000000000000000000000000000000000000000000000000000000000000
00000000000000000000000000000000000000000000000000000000000000000000000000000000
00000000000000000000000000000000000000000000000000000000000000000000000000000000
00000000000000000000000000000000000000000000000000000000000000000000000000000000

image image:library
door @20,5 map:library @18,23 0x0000
